"date","away","away_score","home","home_score","point_diff"
2021-11-27,"McMurry",54,"Abilene Christian",89,35
2021-11-29,"Schreiner",47,"Abilene Christian",88,41
2021-12-01,"University of Dallas",65,"Abilene Christian",108,43
2021-12-04,"Incarnate Word",65,"Abilene Christian",98,33
2021-12-11,"Drexel",56,"Abilene Christian",73,17
2021-12-15,"Cal St. Bakersfield",59,"Abilene Christian",69,10
2021-12-19,"Howard Payne",41,"Abilene Christian",112,71
2021-12-22,"Longwood",58,"Abilene Christian",74,16
2022-01-06,"Stephen F. Austin",64,"Abilene Christian",58,-6
2022-01-08,"Sam Houston St.",65,"Abilene Christian",63,-2
2022-01-20,"Seattle",72,"Abilene Christian",62,-10
2022-01-22,"Cal Baptist",68,"Abilene Christian",77,9
2022-02-02,"Chicago St.",73,"Abilene Christian",77,4
2022-02-05,"UT Rio Grande Valley",66,"Abilene Christian",83,17
2021-11-17,"Texas Southern",57,"Air Force",61,4
2021-11-21,"Bethune Cookman",65,"Air Force",73,8
2021-11-24,"Denver",65,"Air Force",66,1
2021-11-27,"Idaho St.",48,"Air Force",59,11
2021-12-04,"Army",58,"Air Force",76,18
2021-12-29,"Utah St.",47,"Air Force",49,2
2022-01-15,"Nevada",75,"Air Force",68,-7
2022-01-20,"UNLV",62,"Air Force",69,7
2022-01-22,"Colorado St.",73,"Air Force",53,-20
2022-01-28,"Wyoming",63,"Air Force",61,-2
2022-02-05,"New Mexico",91,"Air Force",77,-14
2021-11-13,"Point Park",46,"Akron",102,56
2021-11-18,"Wheeling Jesuit",38,"Akron",99,61
2021-11-24,"Evansville",60,"Akron",69,9
2021-12-01,"Marshall",86,"Akron",88,2
2021-12-04,"Southern",62,"Akron",79,17
2021-12-12,"Florida A&M",66,"Akron",73,7
2022-01-01,"Buffalo",76,"Akron",88,12
2022-01-04,"Ohio",69,"Akron",63,-6
2022-01-11,"Ball St.",74,"Akron",84,10
2022-01-18,"Western Michigan",73,"Akron",74,1
2022-01-22,"Eastern Michigan",44,"Akron",46,2
2022-02-04,"Miami OH",55,"Akron",66,11
2022-02-11,"Kent St.",66,"Akron",64,-2
2021-11-09,"Louisiana Tech",64,"Alabama",93,29
2021-11-12,"South Dakota St.",88,"Alabama",104,16
2021-11-16,"South Alabama",68,"Alabama",73,5
2021-11-19,"Oakland",59,"Alabama",86,27
2021-11-28,"Miami FL",64,"Alabama",96,32
2021-12-11,"Houston",82,"Alabama",83,1
2021-12-18,"Jacksonville St.",59,"Alabama",65,6
2021-12-21,"Davidson",79,"Alabama",78,-1
2021-12-29,"Tennessee",68,"Alabama",73,5
2022-01-11,"Auburn",81,"Alabama",77,-4
2022-01-19,"LSU",67,"Alabama",70,3
2022-01-22,"Missouri",76,"Alabama",86,10
2022-01-29,"Baylor",78,"Alabama",87,9
2022-02-05,"Kentucky",66,"Alabama",55,-11
2022-02-12,"Arkansas",67,"Alabama",68,1
2021-11-09,"Tennessee St.",73,"Alabama A&M",82,9
2022-01-08,"Alcorn St.",78,"Alabama A&M",71,-7
2022-01-10,"Jackson St.",58,"Alabama A&M",60,2
2022-01-29,"Florida A&M",65,"Alabama A&M",60,-5
2022-01-31,"Bethune Cookman",52,"Alabama A&M",67,15
2022-02-12,"Mississippi Valley St.",92,"Alabama A&M",94,2
2021-11-20,"North Carolina Central",74,"Alabama St.",80,6
2021-11-22,"Tuskegee",65,"Alabama St.",91,26
2021-11-28,"North Alabama",81,"Alabama St.",69,-12
2021-12-08,"Samford",74,"Alabama St.",64,-10
2022-01-08,"Jackson St.",57,"Alabama St.",72,15
2022-01-10,"Alcorn St.",70,"Alabama St.",60,-10
2022-01-15,"Alabama A&M",55,"Alabama St.",59,4
2022-01-29,"Bethune Cookman",73,"Alabama St.",79,6
2022-01-31,"Florida A&M",66,"Alabama St.",65,-1
2022-02-12,"Arkansas Pine Bluff",75,"Alabama St.",70,-5
2021-11-09,"Towson",77,"Albany",56,-21
2021-11-17,"Harvard",60,"Albany",53,-7
2021-11-24,"Eastern Illinois",62,"Albany",64,2
2021-12-11,"Columbia",59,"Albany",60,1
2022-01-06,"Binghamton",88,"Albany",79,-9
2022-01-12,"UMass Lowell",47,"Albany",57,10
2022-01-15,"NJIT",56,"Albany",71,15
2022-01-22,"Stony Brook",86,"Albany",75,-11
2022-02-02,"UMBC",59,"Albany",53,-6
2022-02-09,"Maine",73,"Albany",63,-10
2022-02-12,"Vermont",76,"Albany",63,-13
2022-01-15,"Texas Southern",72,"Alcorn St.",73,1
2022-01-17,"Prairie View A&M",74,"Alcorn St.",73,-1
2022-01-29,"Southern",64,"Alcorn St.",68,4
2022-01-31,"Grambling St.",80,"Alcorn St.",73,-7
2022-02-12,"Bethune Cookman",71,"Alcorn St.",63,-8
2021-11-09,"Marist",73,"American",77,4
2021-11-20,"Western Carolina",80,"American",79,-1
2021-12-08,"St. Francis PA",73,"American",83,10
2022-01-01,"Lehigh",63,"American",61,-2
2022-01-10,"Boston University",79,"American",53,-26
2022-01-16,"Bucknell",55,"American",63,8
2022-01-24,"Lafayette",69,"American",56,-13
2022-01-26,"Holy Cross",49,"American",67,18
2022-02-05,"Colgate",86,"American",68,-18
2021-11-12,"East Tennessee St.",67,"Appalachian St.",69,2
2021-11-15,"William Peace",49,"Appalachian St.",98,49
2021-11-18,"Charlotte",67,"Appalachian St.",66,-1
2021-11-23,"Akron",45,"Appalachian St.",57,12
2021-11-24,"Vermont",65,"Appalachian St.",63,-2
2021-11-29,"Hartford",59,"Appalachian St.",69,10
2021-12-01,"Boyce",29,"Appalachian St.",90,61
2021-12-13,"Erskine",44,"Appalachian St.",69,25
2021-12-30,"Louisiana",71,"Appalachian St.",55,-16
2022-01-01,"Louisiana Monroe",69,"Appalachian St.",77,8
2022-01-13,"Coastal Carolina",60,"Appalachian St.",61,1
2022-01-27,"Arkansas St.",54,"Appalachian St.",61,7
2022-01-29,"Little Rock",57,"Appalachian St.",72,15
2022-02-10,"Georgia Southern",61,"Appalachian St.",65,4
2022-02-12,"Georgia St.",58,"Appalachian St.",49,-9
2021-11-09,"Northern Arizona",52,"Arizona",81,29
2021-11-12,"UT Rio Grande Valley",50,"Arizona",104,54
2021-11-16,"North Dakota St.",45,"Arizona",97,52
2021-11-27,"Sacramento St.",59,"Arizona",105,46
2021-12-08,"Wyoming",65,"Arizona",94,29
2021-12-15,"Northern Colorado",76,"Arizona",101,25
2021-12-18,"Cal Baptist",60,"Arizona",84,24
2022-01-03,"Washington",79,"Arizona",95,16
2022-01-13,"Colorado",55,"Arizona",76,21
2022-01-15,"Utah",64,"Arizona",82,18
2022-01-29,"Arizona St.",56,"Arizona",67,11
2022-02-03,"UCLA",66,"Arizona",76,10
2022-02-05,"USC",63,"Arizona",72,9
2021-11-09,"Portland",60,"Arizona St.",76,16
2021-11-11,"UC Riverside",66,"Arizona St.",65,-1
2021-11-15,"North Florida",63,"Arizona St.",72,9
2021-11-24,"Baylor",75,"Arizona St.",63,-12
2021-11-25,"Syracuse",92,"Arizona St.",84,-8
2021-11-26,"Loyola Chicago",77,"Arizona St.",59,-18
2021-12-01,"Washington St.",51,"Arizona St.",29,-22
2021-12-09,"Grand Canyon",62,"Arizona St.",67,5
2021-12-19,"San Francisco",66,"Arizona St.",65,-1
2022-01-15,"Colorado",75,"Arizona St.",57,-18
2022-01-17,"Utah",62,"Arizona St.",64,2
2022-02-03,"USC",58,"Arizona St.",53,-5
2022-02-05,"UCLA",84,"Arizona St.",87,3
2022-02-07,"Arizona",91,"Arizona St.",79,-12
2021-11-09,"Mercer",61,"Arkansas",74,13
2021-11-13,"Gardner Webb",69,"Arkansas",86,17
2021-11-17,"Northern Iowa",80,"Arkansas",93,13
2021-11-23,"Cincinnati",67,"Arkansas",73,6
2021-11-28,"Penn",60,"Arkansas",76,16
2021-12-01,"Central Arkansas",60,"Arkansas",97,37
2021-12-04,"Little Rock",78,"Arkansas",93,15
2021-12-07,"Charlotte",66,"Arkansas",86,20
2021-12-18,"Hofstra",89,"Arkansas",81,-8
2021-12-21,"Elon",55,"Arkansas",81,26
2022-01-04,"Vanderbilt",75,"Arkansas",74,-1
2022-01-12,"Missouri",43,"Arkansas",87,44
2022-01-18,"South Carolina",59,"Arkansas",75,16
2022-01-22,"Texas A&M",73,"Arkansas",76,3
2022-01-29,"West Virginia",68,"Arkansas",77,9
2022-02-05,"Mississippi St.",55,"Arkansas",63,8
2022-02-08,"Auburn",76,"Arkansas",80,4
2021-11-29,"Arkansas Baptist",70,"Arkansas Pine Bluff",75,5
2021-12-08,"Arkansas St.",84,"Arkansas Pine Bluff",73,-11
2021-12-18,"Ecclesia",56,"Arkansas Pine Bluff",97,41
2022-01-03,"Alabama A&M",70,"Arkansas Pine Bluff",50,-20
2022-01-05,"Alabama St.",68,"Arkansas Pine Bluff",70,2
2022-01-15,"Florida A&M",71,"Arkansas Pine Bluff",66,-5
2022-01-17,"Bethune Cookman",63,"Arkansas Pine Bluff",69,6
2022-02-05,"Alcorn St.",70,"Arkansas Pine Bluff",64,-6
2022-02-07,"Jackson St.",60,"Arkansas Pine Bluff",47,-13
2021-11-09,"Harding",55,"Arkansas St.",81,26
2021-11-15,"Central Baptist",63,"Arkansas St.",90,27
2021-11-26,"Morehead St.",75,"Arkansas St.",51,-24
2021-11-28,"UMKC",55,"Arkansas St.",66,11
2021-12-04,"Central Arkansas",82,"Arkansas St.",95,13
2021-12-19,"Air Force",46,"Arkansas St.",68,22
2021-12-21,"Lyon",66,"Arkansas St.",88,22
2022-01-01,"Georgia Southern",56,"Arkansas St.",74,18
2022-01-20,"UT Arlington",70,"Arkansas St.",75,5
2022-01-22,"Texas St.",60,"Arkansas St.",67,7
2022-02-03,"Louisiana Monroe",60,"Arkansas St.",59,-1
2022-02-05,"Louisiana",58,"Arkansas St.",67,9
2021-11-09,"New Paltz",52,"Army",83,31
2021-11-13,"Hartford",79,"Army",86,7
2021-11-17,"Merrimack",51,"Army",74,23
2021-11-27,"Marist",61,"Army",65,4
2021-11-30,"Siena",83,"Army",67,-16
2021-12-07,"Purchase",40,"Army",97,57
2022-01-01,"Loyola MD",74,"Army",77,3
2022-01-07,"Lehigh",55,"Army",77,22
2022-01-13,"Boston University",63,"Army",73,10
2022-01-19,"American",66,"Army",76,10
2022-01-29,"Lafayette",56,"Army",60,4
2022-02-05,"Holy Cross",69,"Army",65,-4
2022-02-12,"Navy",52,"Army",49,-3
2021-11-09,"Morehead St.",54,"Auburn",77,23
2021-11-12,"Louisiana Monroe",65,"Auburn",93,28
2021-11-25,"Loyola Chicago",53,"Auburn",62,9
2021-12-01,"UCF",68,"Auburn",85,17
2021-12-04,"Yale",64,"Auburn",86,22
2021-12-11,"Nebraska",68,"Auburn",99,31
2021-12-14,"North Alabama",44,"Auburn",70,26
2021-12-22,"Murray St.",58,"Auburn",71,13
2021-12-29,"LSU",55,"Auburn",70,15
2022-01-08,"Florida",73,"Auburn",85,12
2022-01-19,"Georgia",60,"Auburn",83,23
2022-01-22,"Kentucky",71,"Auburn",80,9
2022-01-29,"Oklahoma",68,"Auburn",86,18
2022-02-01,"Alabama",81,"Auburn",100,19
2022-02-12,"Texas A&M",58,"Auburn",75,17
2021-11-09,"UT Southern",79,"Austin Peay",86,7
2021-12-05,"Milligan",55,"Austin Peay",98,43
2021-12-30,"Tennessee Martin",65,"Austin Peay",62,-3
2022-01-08,"Morehead St.",66,"Austin Peay",55,-11
2022-01-27,"Belmont",75,"Austin Peay",67,-8
2022-01-31,"SIU Edwardsville",63,"Austin Peay",68,5
2022-02-03,"Murray St.",65,"Austin Peay",53,-12
2022-02-10,"Southeast Missouri St.",66,"Austin Peay",74,8
2022-02-12,"Tennessee St.",52,"Austin Peay",54,2
2021-11-13,"Nebraska Omaha",69,"Ball St.",73,4
2021-11-19,"Weber St.",85,"Ball St.",74,-11
2021-11-21,"Massachusetts",86,"Ball St.",89,3
2021-11-27,"Indiana St.",75,"Ball St.",97,22
2021-12-12,"Indiana Kokomo",58,"Ball St.",85,27
2021-12-21,"Eastern Illinois",55,"Ball St.",75,20
2022-01-01,"Bowling Green",80,"Ball St.",81,1
2022-01-04,"Kent St.",66,"Ball St.",65,-1
2022-01-14,"Buffalo",74,"Ball St.",68,-6
2022-01-25,"Miami OH",64,"Ball St.",81,17
2022-01-29,"Western Michigan",72,"Ball St.",83,11
2022-02-04,"Toledo",83,"Ball St.",93,10
2022-02-08,"Central Michigan",89,"Ball St.",85,-4
2021-11-12,"Incarnate Word",60,"Baylor",87,27
2021-11-15,"Nicholls St.",60,"Baylor",89,29
2021-11-17,"Central Arkansas",47,"Baylor",92,45
2021-11-20,"Stanford",48,"Baylor",86,38
2021-11-25,"VCU",61,"Baylor",69,8
2021-11-26,"Michigan St.",58,"Baylor",75,17
2021-12-04,"Arkansas Pine Bluff",54,"Baylor",99,45
2021-12-12,"Villanova",36,"Baylor",57,21
2021-12-20,"Alcorn St.",57,"Baylor",94,37
2021-12-28,"Northwestern St.",68,"Baylor",104,36
2022-01-04,"Oklahoma",74,"Baylor",84,10
2022-01-11,"Texas Tech",65,"Baylor",62,-3
2022-01-15,"Oklahoma St.",61,"Baylor",54,-7
2022-01-25,"Kansas St.",49,"Baylor",74,25
2022-01-31,"West Virginia",77,"Baylor",81,4
2022-02-12,"Texas",63,"Baylor",80,17
2021-11-28,"Franklin",37,"Bellarmine",75,38
2021-12-05,"Defiance",43,"Bellarmine",92,49
2021-12-09,"Asbury",55,"Bellarmine",87,32
2021-12-10,"Midway",39,"Bellarmine",89,50
2021-12-21,"Loyola Marymount",71,"Bellarmine",57,-14
2022-01-08,"Eastern Kentucky",61,"Bellarmine",66,5
2022-01-11,"Central Arkansas",63,"Bellarmine",85,22
2022-01-18,"North Alabama",60,"Bellarmine",68,8
2022-01-22,"Jacksonville",73,"Bellarmine",76,3
2022-02-03,"Liberty",66,"Bellarmine",53,-13
2022-02-05,"Kennesaw St.",75,"Bellarmine",70,-5
2021-11-13,"Evansville",43,"Belmont",81,38
2021-11-15,"Furman",89,"Belmont",95,6
2021-11-26,"Iona",65,"Belmont",72,7
2021-11-28,"Dayton",63,"Belmont",61,-2
2021-12-02,"Lipscomb",65,"Belmont",94,29
2021-12-15,"Chattanooga",68,"Belmont",76,8
2021-12-18,"Bethel IN",86,"Belmont",115,29
2022-01-06,"Southeast Missouri St.",62,"Belmont",102,40
2022-01-13,"Tennessee Tech",77,"Belmont",92,15
2022-01-15,"Murray St.",82,"Belmont",60,-22
2022-01-29,"Tennessee Martin",58,"Belmont",87,29
2022-02-07,"Austin Peay",58,"Belmont",72,14
2022-02-10,"Morehead St.",47,"Belmont",48,1
2021-11-20,"Bryant",75,"Bethune Cookman",81,6
2021-11-23,"Liberty",59,"Bethune Cookman",51,-8
2021-12-15,"Johnson FL",41,"Bethune Cookman",88,47
2022-01-03,"Florida A&M",59,"Bethune Cookman",66,7
2022-01-08,"Grambling St.",68,"Bethune Cookman",66,-2
2022-01-10,"Southern",69,"Bethune Cookman",59,-10
2022-01-22,"Jackson St.",50,"Bethune Cookman",55,5
2022-01-24,"Alcorn St.",70,"Bethune Cookman",67,-3
2022-02-05,"Prairie View A&M",67,"Bethune Cookman",68,1
2022-02-07,"Texas Southern",66,"Bethune Cookman",63,-3
2021-11-09,"Cornell",76,"Binghamton",69,-7
2021-11-28,"Hartwick",41,"Binghamton",110,69
2021-12-08,"Marist",64,"Binghamton",51,-13
2021-12-11,"SUNY Oneonta",55,"Binghamton",79,24
2022-01-02,"UMass Lowell",63,"Binghamton",68,5
2022-01-08,"NJIT",67,"Binghamton",56,-11
2022-01-19,"Stony Brook",74,"Binghamton",71,-3
2022-01-24,"Hartford",64,"Binghamton",74,10
2022-01-29,"UMBC",70,"Binghamton",68,-2
2022-02-05,"Maine",60,"Binghamton",69,9
2022-02-12,"New Hampshire",69,"Binghamton",60,-9
2021-11-09,"Utah Valley",56,"Boise St.",76,20
2021-11-18,"St. Bonaventure",67,"Boise St.",61,-6
2021-11-26,"Cal St. Bakersfield",46,"Boise St.",39,-7
2021-11-30,"Saint Louis",86,"Boise St.",82,-4
2021-12-03,"Tulsa",58,"Boise St.",63,5
2021-12-10,"Prairie View A&M",60,"Boise St.",97,37
2021-12-14,"Santa Clara",60,"Boise St.",72,12
2021-12-19,"Montana Tech",57,"Boise St.",88,31
2021-12-28,"Fresno St.",55,"Boise St.",65,10
2022-01-18,"Air Force",56,"Boise St.",62,6
2022-01-25,"Wyoming",62,"Boise St.",65,3
2022-02-05,"San Jose St.",60,"Boise St.",76,16
2022-02-11,"UNLV",63,"Boise St.",69,6
2021-11-09,"Dartmouth",57,"Boston College",73,16
2021-11-12,"Holy Cross",55,"Boston College",85,30
2021-11-14,"Fairfield",64,"Boston College",72,8
2021-11-20,"Utah",68,"Boston College",61,-7
2021-11-26,"Columbia",60,"Boston College",73,13
2021-11-29,"South Florida",49,"Boston College",64,15
2021-12-03,"Notre Dame",57,"Boston College",73,16
2021-12-13,"Albany",61,"Boston College",57,-4
2022-01-02,"North Carolina",91,"Boston College",65,-26
2022-01-12,"Georgia Tech",81,"Boston College",76,-5
2022-01-22,"Virginia Tech",63,"Boston College",68,5
2022-01-30,"Pittsburgh",56,"Boston College",69,13
2022-02-08,"Syracuse",73,"Boston College",64,-9
2022-02-12,"Duke",72,"Boston College",61,-11
2021-11-12,"Gordon",61,"Boston University",85,24
2021-11-28,"Merrimack",60,"Boston University",61,1
2021-12-04,"Binghamton",63,"Boston University",68,5
2021-12-08,"UMass Lowell",62,"Boston University",72,10
2021-12-18,"Marist",84,"Boston University",79,-5
2022-01-01,"Bucknell",61,"Boston University",63,2
2022-01-07,"Loyola MD",66,"Boston University",58,-8
2022-01-16,"Navy",72,"Boston University",65,-7
2022-01-22,"Lehigh",74,"Boston University",80,6
2022-01-28,"Colgate",72,"Boston University",76,4
2022-01-31,"Holy Cross",75,"Boston University",70,-5
2022-02-09,"Army",74,"Boston University",75,1
2022-02-12,"American",67,"Boston University",85,18
2021-11-12,"Ohio Wesleyan",60,"Bowling Green",101,41
2021-11-19,"Norfolk St.",90,"Bowling Green",84,-6
2021-11-23,"Milwaukee",68,"Bowling Green",82,14
2021-11-24,"Southern Utah",87,"Bowling Green",73,-14
2021-11-28,"Chicago St.",57,"Bowling Green",75,18
2021-12-07,"Oakland",72,"Bowling Green",73,1
2021-12-19,"Robert Morris",74,"Bowling Green",100,26
2021-12-21,"Carlow",50,"Bowling Green",129,79
2022-01-08,"Miami OH",83,"Bowling Green",87,4
2022-01-15,"Toledo",91,"Bowling Green",78,-13
2022-01-20,"Akron",91,"Bowling Green",66,-25
2022-01-25,"Eastern Michigan",71,"Bowling Green",85,14
2022-01-29,"Kent St.",91,"Bowling Green",83,-8
2022-02-05,"Northern Illinois",65,"Bowling Green",87,22
2021-11-13,"Howard",76,"Bradley",64,-12
2021-11-16,"Missouri S&T",66,"Bradley",92,26
2021-11-27,"Maine",39,"Bradley",71,32
2021-12-01,"Northern Iowa",69,"Bradley",71,2
2021-12-04,"SIU Edwardsville",55,"Bradley",80,25
2021-12-18,"Saint Joseph's",73,"Bradley",77,4
2022-01-05,"Missouri St.",71,"Bradley",69,-2
2022-01-12,"Evansville",47,"Bradley",79,32
2022-01-22,"Southern Illinois",62,"Bradley",70,8
2022-01-30,"Indiana St.",52,"Bradley",67,15
2022-02-09,"Loyola Chicago",61,"Bradley",68,7
2022-02-12,"Drake",59,"Bradley",68,9
2021-11-09,"Salve Regina",59,"Brown",89,30
2021-11-14,"Central Connecticut",57,"Brown",75,18
2021-11-16,"Johnson & Wales RI",47,"Brown",98,51
2021-11-20,"Bradley",62,"Brown",65,3
2021-11-26,"Bryant",65,"Brown",59,-6
2021-12-05,"Sacred Heart",66,"Brown",79,13
2021-12-10,"Vermont",70,"Brown",65,-5
2022-01-17,"Yale",66,"Brown",63,-3
2022-01-30,"Cornell",74,"Brown",72,-2
2022-02-04,"Harvard",65,"Brown",50,-15
2022-02-05,"Dartmouth",60,"Brown",62,2
2021-11-09,"Fisher",54,"Bryant",122,68
2021-11-28,"Dartmouth",63,"Bryant",61,-2
2021-12-08,"New Hampshire",59,"Bryant",76,17
2021-12-31,"Sacred Heart",82,"Bryant",85,3
2022-01-15,"Mount St. Mary's",66,"Bryant",73,7
2022-01-17,"St. Francis PA",52,"Bryant",82,30
2022-01-23,"St. Francis NY",68,"Bryant",85,17
2022-01-27,"Merrimack",67,"Bryant",76,9
2022-01-30,"LIU",81,"Bryant",88,7
2021-11-14,"Penn",73,"Bucknell",68,-5
2021-11-17,"Rider",74,"Bucknell",81,7
2021-11-24,"Rider",85,"Bucknell",79,-6
2021-11-28,"Siena",56,"Bucknell",65,9
2021-12-18,"La Salle",70,"Bucknell",82,12
2022-01-04,"Army",96,"Bucknell",89,-7
2022-01-13,"Lehigh",97,"Bucknell",64,-33
2022-01-19,"Colgate",75,"Bucknell",56,-19
2022-01-26,"Navy",81,"Bucknell",63,-18
2022-01-30,"Loyola MD",80,"Bucknell",82,2
2022-02-09,"American",66,"Bucknell",68,2
2022-02-12,"Holy Cross",78,"Bucknell",72,-6
2021-11-20,"Rider",65,"Buffalo",87,22
2021-11-23,"Stephen F. Austin",79,"Buffalo",78,-1
2021-11-29,"Point Park",49,"Buffalo",94,45
2021-12-11,"St. John Fisher",58,"Buffalo",100,42
2021-12-29,"Miami OH",91,"Buffalo",81,-10
2022-01-05,"Bowling Green",88,"Buffalo",99,11
2022-01-21,"Kent St.",51,"Buffalo",64,13
2022-01-28,"Ohio",74,"Buffalo",53,-21
2022-02-08,"Eastern Michigan",64,"Buffalo",102,38
2022-02-12,"Ball St.",74,"Buffalo",80,6
2021-11-09,"IUPUI",47,"Butler",56,9
2021-11-12,"Central Arkansas",53,"Butler",85,32
2021-11-13,"Troy",59,"Butler",70,11
2021-11-17,"Michigan St.",73,"Butler",52,-21
2021-11-23,"Texas A&M",57,"Butler",50,-7
2021-11-30,"Saginaw Valley St.",57,"Butler",68,11
2021-12-11,"Eastern Illinois",54,"Butler",66,12
2021-12-18,"Purdue",77,"Butler",48,-29
2021-12-29,"DePaul",59,"Butler",63,4
2022-01-04,"Seton Hall",71,"Butler",56,-15
2022-01-07,"Xavier",87,"Butler",72,-15
2022-01-20,"Connecticut",75,"Butler",56,-19
2022-01-26,"Creighton",55,"Butler",72,17
2022-01-29,"Georgetown",53,"Butler",56,3
2022-02-05,"St. John's",75,"Butler",72,-3
2022-02-12,"Marquette",79,"Butler",85,6
2021-11-09,"Cleveland St.",59,"BYU",69,10
2021-11-12,"San Diego St.",60,"BYU",66,6
2021-11-20,"Central Methodist",61,"BYU",97,36
2021-11-24,"Texas Southern",64,"BYU",81,17
2021-12-08,"Utah St.",71,"BYU",82,11
2021-12-25,"Liberty",75,"BYU",80,5
2021-12-29,"Westminster UT",53,"BYU",65,12
2022-01-06,"Pacific",51,"BYU",73,22
2022-01-08,"Saint Mary's",43,"BYU",52,9
2022-01-20,"San Diego",71,"BYU",79,8
2022-01-22,"Portland",65,"BYU",78,13
2022-02-03,"San Francisco",73,"BYU",59,-14
2022-02-05,"Gonzaga",90,"BYU",57,-33
2021-11-09,"San Francisco St.",65,"Cal Baptist",87,22
2021-11-13,"Mississippi Valley St.",66,"Cal Baptist",95,29
2021-11-16,"Jackson St.",64,"Cal Baptist",77,13
2021-11-18,"San Jose St.",66,"Cal Baptist",67,1
2021-11-21,"Northern Colorado",70,"Cal Baptist",74,4
2021-11-27,"San Diego Christian",38,"Cal Baptist",85,47
2021-12-02,"Cal Poly",55,"Cal Baptist",64,9
2021-12-07,"North Dakota",71,"Cal Baptist",89,18
2021-12-21,"Southeast Missouri St.",68,"Cal Baptist",84,16
2021-12-28,"La Verne",41,"Cal Baptist",96,55
2022-01-12,"Dixie St.",79,"Cal Baptist",76,-3
2022-01-15,"Utah Valley",73,"Cal Baptist",75,2
2022-01-17,"Seattle",92,"Cal Baptist",85,-7
2022-01-26,"Sam Houston St.",73,"Cal Baptist",68,-5
2022-01-29,"Stephen F. Austin",81,"Cal Baptist",77,-4
2022-02-10,"Lamar",61,"Cal Baptist",83,22
2022-02-12,"UT Rio Grande Valley",72,"Cal Baptist",80,8
2021-11-09,"Westcliff",53,"Cal Poly",86,33
2021-11-12,"North Dakota St.",60,"Cal Poly",57,-3
2021-11-15,"Sacramento St.",58,"Cal Poly",57,-1
2022-01-13,"UC Riverside",57,"Cal Poly",46,-11
2022-01-15,"UC Davis",74,"Cal Poly",82,8
2022-01-22,"Hawaii",69,"Cal Poly",56,-13
2022-02-10,"Cal St. Northridge",83,"Cal Poly",78,-5
2022-02-12,"UC Santa Barbara",69,"Cal Poly",64,-5
2021-11-13,"Life Pacific",60,"Cal St. Bakersfield",85,25
2021-11-22,"Colorado College",54,"Cal St. Bakersfield",99,45
2021-12-11,"Idaho",58,"Cal St. Bakersfield",59,1
2021-12-21,"Dartmouth",57,"Cal St. Bakersfield",61,4
2021-12-30,"Cal St. Fullerton",73,"Cal St. Bakersfield",67,-6
2022-01-15,"UC Riverside",65,"Cal St. Bakersfield",64,-1
2022-01-18,"Cal Poly",60,"Cal St. Bakersfield",73,13
2022-01-20,"Hawaii",63,"Cal St. Bakersfield",59,-4
2022-02-10,"UC Santa Barbara",74,"Cal St. Bakersfield",62,-12
2022-02-12,"Cal St. Northridge",71,"Cal St. Bakersfield",65,-6
2021-11-16,"George Washington",59,"Cal St. Fullerton",74,15
2021-11-29,"Wyoming",79,"Cal St. Fullerton",66,-13
2021-12-04,"Pacific",57,"Cal St. Fullerton",66,9
2021-12-11,"Life Pacific",59,"Cal St. Fullerton",87,28
2021-12-17,"Redlands",78,"Cal St. Fullerton",93,15
2022-01-13,"Cal St. Northridge",64,"Cal St. Fullerton",79,15
2022-01-15,"UC Santa Barbara",73,"Cal St. Fullerton",79,6
2022-01-22,"UC San Diego",80,"Cal St. Fullerton",83,3
2022-02-03,"Cal Poly",50,"Cal St. Fullerton",61,11
2022-02-05,"Cal St. Bakersfield",61,"Cal St. Fullerton",75,14
2021-11-19,"Eastern Washington",67,"Cal St. Northridge",64,-3
2021-11-20,"Dixie St.",73,"Cal St. Northridge",79,6
2021-11-24,"Saint Katherine",62,"Cal St. Northridge",71,9
2021-12-07,"Boise St.",74,"Cal St. Northridge",48,-26
2021-12-18,"Portland St.",66,"Cal St. Northridge",69,3
2021-12-22,"Bethesda",82,"Cal St. Northridge",80,-2
2022-01-08,"Cal Poly",55,"Cal St. Northridge",68,13
2022-01-20,"UC Davis",64,"Cal St. Northridge",47,-17
2022-01-22,"UC Riverside",77,"Cal St. Northridge",67,-10
2022-01-25,"UC Santa Barbara",72,"Cal St. Northridge",45,-27
2022-02-03,"UC San Diego",83,"Cal St. Northridge",77,-6
2022-02-05,"UC Irvine",75,"Cal St. Northridge",70,-5
2021-11-09,"UC San Diego",80,"California",67,-13
2021-11-15,"San Diego",70,"California",75,5
2021-11-18,"Southern Utah",68,"California",75,7
2021-11-22,"Florida",80,"California",60,-20
2021-11-24,"Seton Hall",62,"California",59,-3
2021-11-28,"Fresno St.",57,"California",65,8
2021-12-02,"Oregon St.",61,"California",73,12
2021-12-08,"Idaho St.",46,"California",72,26
2021-12-11,"Santa Clara",60,"California",72,12
2021-12-19,"Dartmouth",55,"California",61,6
2021-12-22,"Pacific",53,"California",73,20
2022-01-02,"Arizona St.",50,"California",74,24
2022-01-06,"USC",77,"California",63,-14
2022-01-08,"UCLA",60,"California",52,-8
2022-01-23,"Arizona",96,"California",71,-25
2022-02-03,"Washington",84,"California",63,-21
2022-02-05,"Washington St.",68,"California",64,-4
2021-11-09,"William Peace",50,"Campbell",85,35
2021-11-12,"Hartford",67,"Campbell",68,1
2021-11-24,"Maryland Eastern Shore",55,"Campbell",66,11
2021-11-30,"Lancaster Bible",39,"Campbell",83,44
2021-12-07,"Columbia International",56,"Campbell",74,18
2021-12-15,"Georgia Southern",69,"Campbell",66,-3
2022-01-05,"UNC Asheville",60,"Campbell",54,-6
2022-01-12,"Charleston Southern",52,"Campbell",67,15
2022-01-15,"Radford",58,"Campbell",70,12
2022-01-26,"Hampton",60,"Campbell",75,15
2022-01-29,"High Point",72,"Campbell",77,5
2022-02-09,"Gardner Webb",57,"Campbell",45,-12
2021-11-22,"Fredonia St.",40,"Canisius",106,66
2021-11-24,"Coppin St.",75,"Canisius",76,1
2021-11-29,"Cornell",89,"Canisius",75,-14
2021-12-03,"Fairfield",74,"Canisius",68,-6
2021-12-05,"Monmouth",79,"Canisius",65,-14
2021-12-18,"Buffalo",64,"Canisius",65,1
2021-12-22,"Florida Gulf Coast",90,"Canisius",97,7
2022-01-11,"Quinnipiac",67,"Canisius",79,12
2022-01-21,"Rider",69,"Canisius",70,1
2022-01-23,"Saint Peter's",60,"Canisius",63,3
2022-02-04,"Iona",70,"Canisius",62,-8
2022-02-06,"Manhattan",70,"Canisius",77,7
2021-11-20,"Oral Roberts",67,"Central Arkansas",70,3
2021-12-20,"Hendrix",56,"Central Arkansas",90,34
2021-12-31,"Champion Christian",47,"Central Arkansas",119,72
2022-01-09,"Lipscomb",88,"Central Arkansas",93,5
2022-01-15,"North Alabama",88,"Central Arkansas",89,1
2022-01-18,"Jacksonville St.",86,"Central Arkansas",81,-5
2022-02-03,"Florida Gulf Coast",95,"Central Arkansas",93,-2
2022-02-05,"Stetson",75,"Central Arkansas",79,4
2021-11-16,"N.C. State",79,"Central Connecticut",65,-14
2021-11-17,"UMass Lowell",77,"Central Connecticut",53,-24
2021-11-28,"Fordham",89,"Central Connecticut",83,-6
2021-12-01,"Holy Cross",67,"Central Connecticut",73,6
2021-12-18,"Hartford",65,"Central Connecticut",75,10
2021-12-29,"Bryant",80,"Central Connecticut",76,-4
2022-01-08,"Merrimack",66,"Central Connecticut",57,-9
2022-01-27,"LIU",62,"Central Connecticut",65,3
2022-02-03,"Wagner",54,"Central Connecticut",52,-2
2022-02-05,"Fairleigh Dickinson",82,"Central Connecticut",91,9
2022-02-12,"St. Francis NY",67,"Central Connecticut",50,-17
2021-11-23,"Bellarmine",76,"Central Michigan",69,-7
2021-12-05,"Western Illinois",97,"Central Michigan",70,-27
2021-12-11,"Illinois Chicago",71,"Central Michigan",67,-4
2022-01-04,"Toledo",82,"Central Michigan",54,-28
2022-01-25,"Akron",60,"Central Michigan",56,-4
2022-02-01,"Bowling Green",74,"Central Michigan",78,4
2022-02-03,"Western Michigan",55,"Central Michigan",65,10
2022-02-05,"Buffalo",74,"Central Michigan",54,-20
2022-02-10,"Ohio",81,"Central Michigan",72,-9
2021-11-22,"Oregon",73,"Chaminade",49,-24
2021-11-24,"Butler",84,"Chaminade",51,-33
2021-11-11,"South Carolina St.",74,"Charleston",106,32
2021-11-12,"Lipscomb",77,"Charleston",86,9
2021-11-13,"Loyola MD",72,"Charleston",79,7
2021-11-16,"North Carolina",94,"Charleston",83,-11
2021-11-30,"Tulane",77,"Charleston",81,4
2021-12-12,"Presbyterian",76,"Charleston",78,2
2021-12-31,"Delaware",67,"Charleston",66,-1
2022-01-09,"Elon",61,"Charleston",65,4
2022-01-17,"UNC Wilmington",86,"Charleston",78,-8
2022-01-25,"William & Mary",73,"Charleston",74,1
2022-01-27,"Hofstra",76,"Charleston",73,-3
2022-01-29,"Northeastern",63,"Charleston",81,18
2021-11-09,"Johnson & Wales NC",71,"Charleston Southern",118,47
2021-11-20,"Bob Jones",63,"Charleston Southern",119,56
2021-12-02,"Jacksonville",67,"Charleston Southern",56,-11
2021-12-16,"Tennessee St.",78,"Charleston Southern",75,-3
2021-12-20,"Manhattan",99,"Charleston Southern",75,-24
2021-12-21,"South Carolina St.",75,"Charleston Southern",65,-10
2022-01-05,"Gardner Webb",88,"Charleston Southern",63,-25
2022-01-15,"Winthrop",70,"Charleston Southern",65,-5
2022-01-19,"High Point",66,"Charleston Southern",70,4
2022-01-26,"Presbyterian",62,"Charleston Southern",61,-1
2022-01-29,"Hampton",78,"Charleston Southern",74,-4
2022-02-05,"Longwood",69,"Charleston Southern",67,-2
2022-02-07,"Toccoa Falls",60,"Charleston Southern",97,37
2021-11-09,"Monmouth",66,"Charlotte",68,2
2021-11-12,"USC Upstate",64,"Charlotte",76,12
2021-11-22,"Toledo",98,"Charlotte",86,-12
2021-11-30,"Davidson",75,"Charlotte",58,-17
2021-12-04,"George Washington",79,"Charlotte",86,7
2021-12-20,"Maryland Eastern Shore",54,"Charlotte",70,16
2021-12-22,"Western Carolina",82,"Charlotte",98,16
2022-01-13,"UTEP",53,"Charlotte",66,13
2022-01-15,"UTSA",53,"Charlotte",62,9
2022-01-26,"Old Dominion",67,"Charlotte",71,4
2022-02-03,"Western Kentucky",78,"Charlotte",59,-19
2022-02-05,"Marshall",64,"Charlotte",88,24
2022-02-10,"Louisiana Tech",82,"Charlotte",77,-5
2021-11-14,"UNC Asheville",45,"Chattanooga",75,30
2021-11-16,"Tennessee Tech",62,"Chattanooga",69,7
2021-11-23,"Covenant",39,"Chattanooga",100,61
2021-11-27,"Charleston",68,"Chattanooga",66,-2
2021-12-12,"Tennessee Wesleyan",55,"Chattanooga",104,49
2021-12-22,"Middle Tennessee",65,"Chattanooga",77,12
2021-12-30,"East Tennessee St.",52,"Chattanooga",82,30
2022-01-08,"The Citadel",67,"Chattanooga",85,18
2022-01-15,"Furman",69,"Chattanooga",71,2
2022-01-26,"Wofford",60,"Chattanooga",71,11
2022-02-05,"Mercer",68,"Chattanooga",77,9
2022-02-09,"Western Carolina",47,"Chattanooga",65,18
2021-11-09,"St. Thomas",72,"Chicago St.",77,5
2021-11-12,"SIU Edwardsville",56,"Chicago St.",67,11
2021-12-04,"Tennessee St.",49,"Chicago St.",59,10
2021-12-11,"Illinois St.",81,"Chicago St.",71,-10
2021-12-13,"Northern Illinois",70,"Chicago St.",59,-11
2022-01-06,"Seattle",93,"Chicago St.",77,-16
2022-01-08,"Cal Baptist",56,"Chicago St.",58,2
2022-01-27,"Utah Valley",101,"Chicago St.",87,-14
2022-01-29,"Dixie St.",79,"Chicago St.",65,-14
2022-02-10,"Stephen F. Austin",81,"Chicago St.",61,-20
2022-02-12,"Sam Houston St.",72,"Chicago St.",59,-13
2021-11-09,"Evansville",43,"Cincinnati",65,22
2021-11-13,"Georgia",68,"Cincinnati",73,5
2021-11-16,"Alabama A&M",66,"Cincinnati",89,23
2021-11-18,"Presbyterian",45,"Cincinnati",79,34
2021-11-27,"Monmouth",61,"Cincinnati",59,-2
2021-12-05,"Bryant",58,"Cincinnati",73,15
2021-12-14,"Florida A&M",50,"Cincinnati",77,27
2021-12-18,"Ashland",57,"Cincinnati",71,14
2021-12-21,"Tennessee Tech",67,"Cincinnati",76,9
2022-01-01,"Tulane",68,"Cincinnati",60,-8
2022-01-06,"SMU",60,"Cincinnati",77,17
2022-01-12,"East Carolina",71,"Cincinnati",79,8
2022-01-20,"Tulsa",69,"Cincinnati",90,21
2022-02-06,"Houston",80,"Cincinnati",58,-22
2021-11-09,"Presbyterian",53,"Clemson",64,11
2021-11-12,"Wofford",68,"Clemson",76,8
2021-11-15,"Bryant",70,"Clemson",93,23
2021-11-19,"St. Bonaventure",68,"Clemson",65,-3
2021-11-26,"Charleston Southern",59,"Clemson",91,32
2021-12-14,"Miami OH",76,"Clemson",89,13
2021-12-18,"South Carolina",56,"Clemson",70,14
2022-01-04,"Virginia",75,"Clemson",65,-10
2022-01-15,"Boston College",70,"Clemson",68,-2
2022-01-22,"Pittsburgh",48,"Clemson",75,27
2022-02-02,"Florida St.",69,"Clemson",75,6
2022-02-08,"North Carolina",79,"Clemson",77,-2
2022-02-10,"Duke",82,"Clemson",64,-18
2022-02-12,"Notre Dame",76,"Clemson",61,-15
2021-11-13,"Ohio",67,"Cleveland St.",56,-11
2021-11-16,"Edinboro",61,"Cleveland St.",75,14
2021-11-20,"Canisius",70,"Cleveland St.",80,10
2021-11-22,"Coppin St.",62,"Cleveland St.",65,3
2021-11-27,"Penn State Behrend",47,"Cleveland St.",89,42
2021-12-02,"Northern Kentucky",58,"Cleveland St.",72,14
2021-12-04,"Wright St.",75,"Cleveland St.",85,10
2021-12-30,"Purdue Fort Wayne",81,"Cleveland St.",90,9
2022-01-05,"Purdue Fort Wayne",58,"Cleveland St.",65,7
2022-01-13,"Oakland",70,"Cleveland St.",65,-5
2022-01-15,"Detroit Mercy",70,"Cleveland St.",72,2
2022-01-21,"Youngstown St.",61,"Cleveland St.",64,3
2022-01-23,"Robert Morris",68,"Cleveland St.",75,7
2022-02-04,"Green Bay",69,"Cleveland St.",85,16
2022-02-06,"Milwaukee",71,"Cleveland St.",84,13
2022-02-10,"Illinois Chicago",76,"Cleveland St.",75,-1
2022-02-12,"IUPUI",45,"Cleveland St.",83,38
2021-11-09,"Ferrum",73,"Coastal Carolina",101,28
2021-11-23,"Valparaiso",61,"Coastal Carolina",64,3
2021-11-24,"Toledo",79,"Coastal Carolina",70,-9
2021-12-01,"South Carolina",56,"Coastal Carolina",80,24
2021-12-04,"Winthrop",64,"Coastal Carolina",74,10
2021-12-06,"Mercer",74,"Coastal Carolina",69,-5
2021-12-12,"Wofford",59,"Coastal Carolina",60,1
2021-12-15,"Methodist",42,"Coastal Carolina",102,60
2021-12-16,"Regent",53,"Coastal Carolina",110,57
2021-12-30,"Louisiana Monroe",64,"Coastal Carolina",94,30
2022-01-01,"Louisiana",65,"Coastal Carolina",64,-1
2022-01-02,"Emory & Henry",62,"Coastal Carolina",76,14
2022-01-15,"Appalachian St.",84,"Coastal Carolina",76,-8
2022-01-27,"Little Rock",49,"Coastal Carolina",65,16
2022-01-29,"Arkansas St.",73,"Coastal Carolina",66,-7
2022-02-10,"Georgia St.",61,"Coastal Carolina",50,-11
2022-02-12,"Georgia Southern",58,"Coastal Carolina",79,21
2021-11-09,"Northeastern",58,"Colgate",65,7
2021-11-18,"SUNY Poly",50,"Colgate",97,47
2021-11-29,"Niagara",70,"Colgate",59,-11
2021-12-06,"Columbia",61,"Colgate",89,28
2022-01-10,"Army",57,"Colgate",76,19
2022-01-24,"Loyola MD",52,"Colgate",65,13
2022-02-02,"Bucknell",69,"Colgate",83,14
2022-02-07,"Holy Cross",60,"Colgate",87,27
2022-02-09,"Lehigh",62,"Colgate",78,16
2021-11-09,"Montana St.",90,"Colorado",94,4
2021-11-13,"New Mexico",76,"Colorado",87,11
2021-11-15,"Maine",46,"Colorado",90,44
2021-11-19,"Southern Illinois",67,"Colorado",63,-4
2021-11-20,"Duquesne",76,"Colorado",84,8
2021-11-22,"Brown",52,"Colorado",54,2
2021-11-28,"Stanford",76,"Colorado",80,4
2021-12-04,"Tennessee",69,"Colorado",54,-15
2021-12-08,"Eastern Washington",57,"Colorado",60,3
2021-12-10,"Milwaukee",54,"Colorado",65,11
2021-12-18,"Cal St. Bakersfield",46,"Colorado",60,14
2022-01-06,"Washington St.",78,"Colorado",83,5
2022-01-09,"Washington",64,"Colorado",78,14
2022-01-20,"USC",61,"Colorado",58,-3
2022-01-22,"UCLA",71,"Colorado",65,-6
2022-02-03,"Oregon",66,"Colorado",51,-15
2022-02-05,"Oregon St.",63,"Colorado",86,23
2022-02-12,"Utah",76,"Colorado",81,5
2021-11-09,"Oral Roberts",80,"Colorado St.",109,29
2021-11-12,"Arkansas Pine Bluff",71,"Colorado St.",91,20
2021-11-14,"Peru St.",62,"Colorado St.",88,26
2021-11-19,"Bradley",60,"Colorado St.",66,6
2021-11-27,"Northern Colorado",79,"Colorado St.",88,9
2021-12-01,"Little Rock",55,"Colorado St.",86,31
2021-12-04,"Saint Mary's",58,"Colorado St.",74,16
2022-01-04,"Air Force",59,"Colorado St.",67,8
2022-01-12,"Utah St.",72,"Colorado St.",77,5
2022-01-19,"New Mexico",74,"Colorado St.",80,6
2022-01-25,"Nevada",66,"Colorado St.",77,11
2022-01-28,"UNLV",88,"Colorado St.",74,-14
2022-02-04,"San Diego St.",57,"Colorado St.",58,1
2022-02-11,"Fresno St.",50,"Colorado St.",65,15
2021-11-12,"Marist",82,"Columbia",67,-15
2021-11-17,"Binghamton",77,"Columbia",85,8
2021-11-20,"Mount Saint Vincent",62,"Columbia",87,25
2021-11-29,"Lafayette",73,"Columbia",50,-23
2021-12-04,"Maine",66,"Columbia",77,11
2021-12-13,"Sacred Heart",79,"Columbia",69,-10
2022-01-15,"Harvard",91,"Columbia",82,-9
2022-01-22,"Brown",93,"Columbia",74,-19
2022-01-29,"Dartmouth",76,"Columbia",63,-13
2022-02-04,"Penn",81,"Columbia",66,-15
2022-02-05,"Princeton",85,"Columbia",63,-22
2022-02-12,"Yale",84,"Columbia",59,-25
2021-11-09,"Central Connecticut",48,"Connecticut",99,51
2021-11-13,"Coppin St.",54,"Connecticut",89,35
2021-11-17,"LIU",40,"Connecticut",93,53
2021-11-20,"Binghamton",63,"Connecticut",87,24
2021-11-24,"Auburn",109,"Connecticut",115,6
2021-11-25,"Michigan St.",64,"Connecticut",60,-4
2021-11-30,"Maryland Eastern Shore",63,"Connecticut",72,9
2021-12-04,"Grambling St.",59,"Connecticut",88,29
2021-12-11,"St. Bonaventure",64,"Connecticut",74,10
2021-12-18,"Providence",57,"Connecticut",53,-4
2022-01-12,"St. John's",78,"Connecticut",86,8
2022-01-18,"Butler",59,"Connecticut",76,17
2022-01-25,"Georgetown",73,"Connecticut",96,23
2022-02-01,"Creighton",59,"Connecticut",55,-4
2022-02-08,"Marquette",72,"Connecticut",80,8
2021-11-17,"Loyola MD",49,"Coppin St.",71,22
2021-12-11,"Towson",89,"Coppin St.",75,-14
2022-01-24,"Howard",81,"Coppin St.",83,2
2022-01-29,"Maryland Eastern Shore",64,"Coppin St.",61,-3
2022-02-12,"South Carolina St.",66,"Coppin St.",58,-8
2021-11-16,"Colgate",68,"Cornell",78,10
2021-11-19,"Wells",48,"Cornell",107,59
2021-11-24,"St. Francis PA",80,"Cornell",93,13
2021-12-03,"Coppin St.",77,"Cornell",92,15
2021-12-05,"Keuka",64,"Cornell",122,58
2022-01-02,"Dartmouth",71,"Cornell",79,8
2022-01-22,"Harvard",61,"Cornell",76,15
2022-02-04,"Princeton",83,"Cornell",88,5
2022-02-05,"Penn",73,"Cornell",68,-5
2022-02-09,"Columbia",75,"Cornell",88,13
2022-02-12,"Brown",81,"Cornell",80,-1
2021-11-09,"Arkansas Pine Bluff",77,"Creighton",90,13
2021-11-11,"Kennesaw St.",44,"Creighton",51,7
2021-11-19,"Brown",57,"Creighton",78,21
2021-11-21,"Colorado St.",95,"Creighton",81,-14
2021-11-27,"SIU Edwardsville",65,"Creighton",70,5
2021-11-30,"North Dakota St.",55,"Creighton",80,25
2021-12-04,"Iowa St.",64,"Creighton",58,-6
2021-12-11,"BYU",71,"Creighton",83,12
2021-12-14,"Arizona St.",58,"Creighton",57,-1
2021-12-17,"Villanova",59,"Creighton",79,20
2022-01-19,"St. John's",64,"Creighton",87,23
2022-01-22,"DePaul",47,"Creighton",60,13
2022-01-29,"Xavier",74,"Creighton",64,-10
2022-02-08,"Butler",52,"Creighton",54,2
2021-11-16,"Northern Vermont",74,"Dartmouth",114,40
2021-12-08,"Quinnipiac",72,"Dartmouth",69,-3
2021-12-11,"Boston University",65,"Dartmouth",62,-3
2022-01-08,"Brown",46,"Dartmouth",58,12
2022-01-17,"Harvard",60,"Dartmouth",59,-1
2022-01-22,"Princeton",84,"Dartmouth",80,-4
2021-11-09,"Delaware",71,"Davidson",93,22
2021-11-27,"Robert Morris",70,"Davidson",88,18
2021-12-04,"William & Mary",46,"Davidson",70,24
2021-12-18,"Radford",54,"Davidson",74,20
2021-12-22,"Johnson & Wales NC",64,"Davidson",106,42
2022-01-08,"Rhode Island",68,"Davidson",72,4
2022-01-11,"Massachusetts",67,"Davidson",77,10
2022-01-26,"VCU",70,"Davidson",68,-2
2022-01-29,"La Salle",69,"Davidson",77,8
2022-02-09,"Saint Joseph's",67,"Davidson",73,6
2021-11-09,"Illinois Chicago",54,"Dayton",64,10
2021-11-13,"UMass Lowell",59,"Dayton",58,-1
2021-11-17,"Lipscomb",78,"Dayton",59,-19
2021-11-20,"Austin Peay",87,"Dayton",81,-6
2021-12-01,"Alabama St.",54,"Dayton",93,39
2021-12-04,"Northern Illinois",41,"Dayton",79,38
2021-12-12,"Virginia Tech",57,"Dayton",62,5
2021-12-21,"Southern",60,"Dayton",69,9
2022-01-05,"VCU",53,"Dayton",52,-1
2022-01-11,"Saint Louis",63,"Dayton",68,5
2022-01-18,"St. Bonaventure",50,"Dayton",68,18
2022-01-25,"Fordham",61,"Dayton",68,7
2022-01-28,"Rhode Island",51,"Dayton",53,2
2022-02-09,"Duquesne",54,"Dayton",75,21
2022-02-12,"George Washington",54,"Dayton",80,26
2021-11-17,"La Salle",82,"Delaware",85,3
2021-11-22,"Appalachian St.",68,"Delaware",75,7
2021-11-23,"Fordham",71,"Delaware",81,10
2021-11-24,"Oakland",81,"Delaware",73,-8
2021-11-30,"LIU",67,"Delaware",75,8
2021-12-05,"UMBC",60,"Delaware",70,10
2021-12-08,"Lafayette",58,"Delaware",68,10
2021-12-10,"Moravian",55,"Delaware",94,39
2022-01-20,"William & Mary",74,"Delaware",84,10
2022-01-22,"Elon",77,"Delaware",80,3
2022-01-24,"Towson",69,"Delaware",62,-7
2022-02-03,"Drexel",76,"Delaware",68,-8
2022-02-10,"Northeastern",61,"Delaware",74,13
2022-02-12,"Hofstra",80,"Delaware",66,-14
2021-11-09,"Cairn",41,"Delaware St.",80,39
2021-11-12,"Salisbury",91,"Delaware St.",78,-13
2021-11-16,"Regent",30,"Delaware St.",84,54
2021-11-20,"UNC Wilmington",67,"Delaware St.",63,-4
2021-12-02,"Delaware",59,"Delaware St.",48,-11
2021-12-11,"St. Francis NY",75,"Delaware St.",61,-14
2021-12-18,"North Carolina Central",86,"Delaware St.",53,-33
2022-01-22,"North Carolina Central",73,"Delaware St.",49,-24
2022-01-24,"South Carolina St.",64,"Delaware St.",62,-2
2022-02-02,"Coppin St.",59,"Delaware St.",57,-2
2022-02-07,"Howard",69,"Delaware St.",64,-5
2022-02-09,"Maryland Eastern Shore",58,"Delaware St.",50,-8
2021-11-09,"Regis",65,"Denver",68,3
2021-11-12,"Ottawa AZ",72,"Denver",71,-1
2021-11-21,"Houston Baptist",61,"Denver",74,13
2021-12-15,"UC San Diego",56,"Denver",64,8
2021-12-20,"Western Illinois",84,"Denver",80,-4
2021-12-22,"St. Thomas",74,"Denver",75,1
2022-01-08,"North Dakota",74,"Denver",93,19
2022-01-10,"North Dakota St.",87,"Denver",69,-18
2022-01-22,"Nebraska Omaha",63,"Denver",94,31
2022-01-27,"UMKC",72,"Denver",61,-11
2022-01-29,"Oral Roberts",89,"Denver",80,-9
2022-02-10,"South Dakota St.",84,"Denver",61,-23
2022-02-12,"South Dakota",84,"Denver",76,-8
2021-11-10,"Coppin St.",72,"DePaul",97,25
2021-11-13,"Central Michigan",66,"DePaul",99,33
2021-11-18,"Rutgers",70,"DePaul",73,3
2021-11-20,"Western Illinois",80,"DePaul",84,4
2021-11-26,"Northern Kentucky",68,"DePaul",77,9
2021-11-28,"Eastern Michigan",63,"DePaul",101,38
2021-12-04,"Loyola Chicago",68,"DePaul",64,-4
2021-12-07,"Duquesne",67,"DePaul",87,20
2022-01-01,"Providence",70,"DePaul",53,-17
2022-01-08,"Villanova",79,"DePaul",64,-15
2022-01-13,"Seton Hall",92,"DePaul",96,4
2022-01-19,"Xavier",68,"DePaul",67,-1
2022-01-29,"Connecticut",57,"DePaul",50,-7
2022-02-09,"Georgetown",74,"DePaul",82,8
2021-12-11,"Western Michigan",64,"Detroit Mercy",83,19
2021-12-19,"Central Michigan",75,"Detroit Mercy",89,14
2022-01-07,"Milwaukee",60,"Detroit Mercy",85,25
2022-01-27,"Illinois Chicago",67,"Detroit Mercy",80,13
2022-01-31,"Michigan Dearborn",51,"Detroit Mercy",96,45
2021-11-12,"Southern Utah",76,"Dixie St.",83,7
2021-11-19,"Texas St.",85,"Dixie St.",65,-20
2021-11-27,"Weber St.",87,"Dixie St.",70,-17
2021-11-30,"Bethesda",61,"Dixie St.",99,38
2021-12-01,"Bethesda",67,"Dixie St.",99,32
2021-12-04,"Saint Katherine",65,"Dixie St.",97,32
2021-12-11,"Denver",62,"Dixie St.",82,20
2021-12-15,"American Indian",49,"Dixie St.",114,65
2021-12-30,"Tarleton St.",83,"Dixie St.",69,-14
2022-01-01,"Abilene Christian",64,"Dixie St.",50,-14
2022-01-20,"Lamar",55,"Dixie St.",71,16
2022-01-22,"UT Rio Grande Valley",74,"Dixie St.",85,11
2022-02-10,"New Mexico St.",77,"Dixie St.",69,-8
2022-02-12,"Grand Canyon",60,"Dixie St.",61,1
2021-11-09,"Coe",61,"Drake",87,26
2021-11-14,"South Dakota",50,"Drake",99,49
2021-11-20,"Richmond",70,"Drake",73,3
2021-11-25,"Belmont",74,"Drake",69,-5
2021-11-26,"Alabama",80,"Drake",71,-9
2021-11-28,"North Texas",57,"Drake",54,-3
2021-12-02,"Valparaiso",66,"Drake",73,7
2021-12-05,"St. Thomas",64,"Drake",74,10
2021-12-11,"Clemson",90,"Drake",80,-10
2021-12-16,"Jackson St.",65,"Drake",70,5
2021-12-19,"Tennessee Martin",54,"Drake",80,26
2021-12-22,"Chicago St.",50,"Drake",87,37
2021-12-28,"Mount Marty",53,"Drake",82,29
2022-01-12,"Illinois St.",75,"Drake",86,11
2022-01-19,"Bradley",83,"Drake",71,-12
2022-01-30,"Loyola Chicago",68,"Drake",77,9
2022-02-05,"Northern Iowa",74,"Drake",69,-5
2022-02-09,"Missouri St.",66,"Drake",62,-4
2021-11-09,"Neumann",74,"Drexel",103,29
2021-11-23,"Charlotte",55,"Drexel",67,12
2021-12-02,"Fairleigh Dickinson",65,"Drexel",86,21
2021-12-14,"Coppin St.",69,"Drexel",76,7
2022-01-03,"Towson",61,"Drexel",65,4
2022-01-11,"Delaware",81,"Drexel",77,-4
2022-01-20,"Elon",49,"Drexel",77,28
2022-01-22,"William & Mary",83,"Drexel",75,-8
2022-02-07,"James Madison",66,"Drexel",72,6
2022-02-10,"Hofstra",83,"Drexel",73,-10
2022-02-12,"Northeastern",51,"Drexel",67,16
2021-11-09,"Kentucky",71,"Duke",79,8
2021-11-12,"Army",56,"Duke",82,26
2021-11-13,"Campbell",56,"Duke",67,11
2021-11-16,"Gardner Webb",52,"Duke",92,40
2021-11-19,"Lafayette",55,"Duke",88,33
2021-11-22,"The Citadel",81,"Duke",107,26
2021-11-26,"Gonzaga",81,"Duke",84,3
2021-12-14,"South Carolina St.",62,"Duke",103,41
2021-12-16,"Appalachian St.",67,"Duke",92,25
2021-12-18,"Elon",56,"Duke",87,31
2021-12-22,"Virginia Tech",65,"Duke",76,11
2022-01-04,"Georgia Tech",57,"Duke",69,12
2022-01-08,"Miami FL",76,"Duke",74,-2
2022-01-15,"N.C. State",73,"Duke",88,15
2022-01-22,"Syracuse",59,"Duke",79,20
2022-01-25,"Clemson",69,"Duke",71,2
2022-02-07,"Virginia",69,"Duke",68,-1
2021-11-09,"Rider",61,"Duquesne",73,12
2021-11-13,"Hofstra",73,"Duquesne",63,-10
2021-11-15,"Weber St.",63,"Duquesne",59,-4
2021-11-19,"Northeastern",71,"Duquesne",55,-16
2021-11-22,"Bradley",70,"Duquesne",78,8
2021-11-28,"American",79,"Duquesne",88,9
2021-12-01,"Bowling Green",78,"Duquesne",70,-8
2021-12-11,"New Hampshire",62,"Duquesne",64,2
2021-12-19,"UC Irvine",54,"Duquesne",76,22
2022-01-15,"Dayton",72,"Duquesne",52,-20
2022-01-21,"St. Bonaventure",64,"Duquesne",56,-8
2022-01-29,"Saint Louis",77,"Duquesne",53,-24
2022-02-01,"Richmond",74,"Duquesne",57,-17
2022-02-12,"Fordham",65,"Duquesne",54,-11
2021-11-09,"South Carolina St.",62,"East Carolina",70,8
2021-11-12,"Canisius",71,"East Carolina",83,12
2021-11-14,"Western Carolina",79,"East Carolina",95,16
2021-11-18,"Oklahoma",79,"East Carolina",74,-5
2021-11-21,"Davidson",76,"East Carolina",67,-9
2021-11-27,"Coppin St.",68,"East Carolina",70,2
2021-11-30,"Old Dominion",62,"East Carolina",63,1
2021-12-04,"Gardner Webb",52,"East Carolina",62,10
2021-12-07,"North Carolina A&T",71,"East Carolina",82,11
2021-12-17,"Liberty",74,"East Carolina",64,-10
2021-12-21,"Southern Miss",67,"East Carolina",68,1
2022-01-05,"Tulane",80,"East Carolina",88,8
2022-01-15,"Memphis",71,"East Carolina",72,1
2022-01-18,"UCF",92,"East Carolina",85,-7
2022-01-30,"Cincinnati",60,"East Carolina",59,-1
2022-02-02,"Temple",71,"East Carolina",63,-8
2022-02-12,"SMU",80,"East Carolina",66,-14
2021-11-18,"USC Upstate",43,"East Tennessee St.",56,13
2021-11-24,"Kent St.",51,"East Tennessee St.",57,6
2021-11-27,"Lees McRae",74,"East Tennessee St.",92,18
2021-12-04,"Lenoir Rhyne",66,"East Tennessee St.",90,24
2021-12-11,"Morehead St.",75,"East Tennessee St.",82,7
2021-12-14,"North Carolina A&T",69,"East Tennessee St.",67,-2
2022-01-05,"VMI",79,"East Tennessee St.",80,1
2022-01-08,"Wofford",68,"East Tennessee St.",57,-11
2022-01-10,"Western Carolina",69,"East Tennessee St.",87,18
2022-01-19,"Mercer",64,"East Tennessee St.",72,8
2022-01-22,"The Citadel",75,"East Tennessee St.",73,-2
2022-01-26,"UNC Greensboro",80,"East Tennessee St.",76,-4
2022-02-07,"Furman",71,"East Tennessee St.",75,4
2022-02-12,"Samford",77,"East Tennessee St.",73,-4
2021-11-15,"Central Michigan",62,"Eastern Illinois",61,-1
2021-11-18,"Rockford",64,"Eastern Illinois",96,32
2021-11-28,"Evansville",70,"Eastern Illinois",54,-16
2021-12-04,"North Park",71,"Eastern Illinois",76,5
2022-01-13,"SIU Edwardsville",66,"Eastern Illinois",53,-13
2022-01-17,"Murray St.",72,"Eastern Illinois",46,-26
2022-01-22,"Southeast Missouri St.",87,"Eastern Illinois",58,-29
2022-01-24,"Belmont",90,"Eastern Illinois",56,-34
2022-01-29,"Tennessee St.",57,"Eastern Illinois",62,5
2022-02-10,"Tennessee Tech",73,"Eastern Illinois",62,-11
2022-02-12,"Tennessee Martin",70,"Eastern Illinois",82,12
2021-11-09,"Georgetown KY",63,"Eastern Kentucky",93,30
2021-11-11,"Ohio Valley",74,"Eastern Kentucky",103,29
2021-11-16,"James Madison",79,"Eastern Kentucky",78,-1
2021-11-20,"Albany",64,"Eastern Kentucky",77,13
2021-11-22,"Eastern Illinois",43,"Eastern Kentucky",82,39
2021-12-11,"Marshall",80,"Eastern Kentucky",69,-11
2021-12-15,"Midway",67,"Eastern Kentucky",121,54
2021-12-18,"Northern Kentucky",68,"Eastern Kentucky",81,13
2021-12-31,"Alice Lloyd",52,"Eastern Kentucky",106,54
2022-01-04,"Central Arkansas",79,"Eastern Kentucky",72,-7
2022-01-15,"Jacksonville St.",76,"Eastern Kentucky",65,-11
2022-01-18,"Lipscomb",72,"Eastern Kentucky",86,14
2022-01-22,"North Florida",58,"Eastern Kentucky",67,9
2022-02-03,"Kennesaw St.",81,"Eastern Kentucky",82,1
2022-02-05,"Liberty",91,"Eastern Kentucky",84,-7
2021-11-12,"Illinois St.",98,"Eastern Michigan",103,5
2021-11-24,"Western Illinois",68,"Eastern Michigan",72,4
2021-12-05,"Northwood MI",57,"Eastern Michigan",79,22
2021-12-08,"Niagara",58,"Eastern Michigan",60,2
2021-12-11,"FIU",88,"Eastern Michigan",92,4
2022-01-08,"Ball St.",78,"Eastern Michigan",72,-6
2022-01-11,"Central Michigan",68,"Eastern Michigan",99,31
2022-01-18,"Kent St.",56,"Eastern Michigan",47,-9
2022-01-29,"Miami OH",75,"Eastern Michigan",85,10
2022-02-01,"Toledo",86,"Eastern Michigan",66,-20
2022-02-12,"Ohio",74,"Eastern Michigan",56,-18
2021-11-15,"Walla Walla",71,"Eastern Washington",111,40
2021-11-20,"Texas St.",81,"Eastern Washington",74,-7
2021-12-02,"Southern Utah",89,"Eastern Washington",76,-13
2021-12-15,"Multnomah",56,"Eastern Washington",95,39
2022-01-06,"Montana",90,"Eastern Washington",78,-12
2022-01-08,"Idaho",93,"Eastern Washington",96,3
2022-01-20,"Sacramento St.",62,"Eastern Washington",75,13
2022-01-22,"Northern Colorado",87,"Eastern Washington",83,-4
2022-02-10,"Weber St.",67,"Eastern Washington",75,8
2022-02-12,"Idaho St.",72,"Eastern Washington",75,3
2021-11-12,"Randolph",62,"Elon",107,45
2021-11-14,"Bluefield",72,"Elon",89,17
2021-11-19,"Mississippi",74,"Elon",56,-18
2021-11-21,"Temple",75,"Elon",58,-17
2021-11-27,"Jacksonville St.",93,"Elon",81,-12
2021-12-04,"High Point",83,"Elon",77,-6
2021-12-15,"Winthrop",61,"Elon",63,2
2021-12-29,"Northeastern",62,"Elon",79,17
2022-01-15,"Towson",59,"Elon",54,-5
2022-01-17,"James Madison",67,"Elon",90,23
2022-01-27,"William & Mary",54,"Elon",61,7
2022-02-03,"UNC Wilmington",65,"Elon",78,13
2022-02-05,"Charleston",66,"Elon",64,-2
2021-11-11,"IUPUI",40,"Evansville",60,20
2021-11-16,"DePauw",58,"Evansville",69,11
2021-11-20,"UCF",75,"Evansville",59,-16
2021-11-22,"Rice",109,"Evansville",104,-5
2021-12-01,"Southern Illinois",54,"Evansville",52,-2
2021-12-04,"Tennessee Tech",51,"Evansville",59,8
2022-01-08,"Drake",60,"Evansville",59,-1
2022-01-18,"Loyola Chicago",77,"Evansville",48,-29
2022-01-23,"Illinois St.",53,"Evansville",56,3
2022-01-26,"Northern Iowa",64,"Evansville",59,-5
2022-02-05,"Bradley",76,"Evansville",41,-35
2022-02-10,"Indiana St.",80,"Evansville",77,-3
2021-11-16,"Medgar Evers",55,"Fairfield",110,55
2021-11-24,"Stony Brook",78,"Fairfield",83,5
2021-11-28,"Loyola MD",75,"Fairfield",70,-5
2021-12-08,"Holy Cross",59,"Fairfield",74,15
2021-12-23,"Wagner",63,"Fairfield",50,-13
2022-01-07,"Marist",60,"Fairfield",51,-9
2022-01-11,"Iona",80,"Fairfield",76,-4
2022-01-20,"Monmouth",61,"Fairfield",58,-3
2022-02-06,"Siena",62,"Fairfield",56,-6
2022-02-09,"Quinnipiac",69,"Fairfield",60,-9
2022-02-12,"Niagara",53,"Fairfield",73,20
2021-12-15,"Fairfield",72,"Fairleigh Dickinson",54,-18
2022-01-21,"St. Francis NY",80,"Fairleigh Dickinson",78,-2
2022-01-23,"LIU",79,"Fairleigh Dickinson",75,-4
2022-01-27,"Mount St. Mary's",67,"Fairleigh Dickinson",56,-11
2022-01-30,"Central Connecticut",55,"Fairleigh Dickinson",75,20
2022-02-10,"St. Francis PA",78,"Fairleigh Dickinson",65,-13
2022-02-12,"Sacred Heart",75,"Fairleigh Dickinson",82,7
2021-11-12,"Trinity FL",48,"FIU",111,63
2021-11-18,"Ball St.",60,"FIU",73,13
2021-11-21,"UNC Greensboro",71,"FIU",74,3
2021-11-24,"North Dakota",56,"FIU",65,9
2021-11-28,"North Florida",69,"FIU",84,15
2021-12-01,"Florida Gulf Coast",61,"FIU",77,16
2021-12-04,"Stetson",65,"FIU",72,7
2021-12-30,"Old Dominion",82,"FIU",77,-5
2022-01-01,"St. Thomas FL",72,"FIU",95,23
2022-01-05,"Bethune Cookman",65,"FIU",68,3
2022-01-20,"Marshall",66,"FIU",70,4
2022-01-22,"Western Kentucky",83,"FIU",86,3
2022-02-03,"Southern Miss",67,"FIU",77,10
2022-02-05,"Louisiana Tech",86,"FIU",82,-4
2022-02-07,"Charlotte",81,"FIU",68,-13
2021-11-09,"Elon",61,"Florida",74,13
2021-11-14,"Florida St.",55,"Florida",71,16
2021-11-18,"Milwaukee",45,"Florida",81,36
2021-11-24,"Ohio St.",68,"Florida",71,3
2021-11-28,"Troy",45,"Florida",84,39
2021-12-06,"Texas Southern",69,"Florida",54,-15
2021-12-08,"North Florida",55,"Florida",85,30
2021-12-22,"Stony Brook",62,"Florida",87,25
2022-01-05,"Alabama",83,"Florida",70,-13
2022-01-12,"LSU",64,"Florida",58,-6
2022-01-19,"Mississippi St.",72,"Florida",80,8
2022-01-22,"Vanderbilt",42,"Florida",61,19
2022-01-29,"Oklahoma St.",72,"Florida",81,9
2022-02-05,"Mississippi",57,"Florida",62,5
2022-02-09,"Georgia",63,"Florida",72,9
2021-11-15,"LeMoyne Owen",70,"Florida A&M",95,25
2021-12-01,"Fort Valley St.",63,"Florida A&M",76,13
2021-12-07,"Florida Gulf Coast",69,"Florida A&M",55,-14
2022-01-08,"Southern",80,"Florida A&M",66,-14
2022-01-10,"Grambling St.",66,"Florida A&M",75,9
2022-01-22,"Alcorn St.",68,"Florida A&M",70,2
2022-01-24,"Jackson St.",64,"Florida A&M",67,3
2022-02-05,"Texas Southern",67,"Florida A&M",55,-12
2022-02-07,"Prairie View A&M",60,"Florida A&M",61,1
2021-11-13,"Warner",56,"Florida Atlantic",78,22
2021-11-16,"Miami FL",68,"Florida Atlantic",66,-2
2021-11-19,"Tennessee Martin",67,"Florida Atlantic",75,8
2021-11-20,"North Dakota",79,"Florida Atlantic",98,19
2021-11-22,"Troy",83,"Florida Atlantic",78,-5
2021-11-28,"James Madison",69,"Florida Atlantic",65,-4
2021-12-01,"Stetson",73,"Florida Atlantic",83,10
2021-12-05,"North Florida",41,"Florida Atlantic",76,35
2021-12-08,"Palm Beach Atlantic",63,"Florida Atlantic",84,21
2021-12-17,"Florida Tech",55,"Florida Atlantic",78,23
2022-01-17,"Charlotte",67,"Florida Atlantic",96,29
2022-01-20,"Western Kentucky",69,"Florida Atlantic",78,9
2022-01-22,"Marshall",60,"Florida Atlantic",71,11
2022-02-03,"Louisiana Tech",73,"Florida Atlantic",83,10
2022-02-05,"Southern Miss",57,"Florida Atlantic",84,27
2022-02-08,"Old Dominion",62,"Florida Atlantic",81,19
2021-11-09,"Florida National",57,"Florida Gulf Coast",94,37
2021-11-16,"USC",78,"Florida Gulf Coast",61,-17
2021-11-21,"Eckerd",59,"Florida Gulf Coast",99,40
2021-11-23,"Rhode Island",66,"Florida Gulf Coast",67,1
2021-11-26,"Western Michigan",67,"Florida Gulf Coast",77,10
2021-11-27,"Southeastern Louisiana",71,"Florida Gulf Coast",90,19
2021-11-28,"Purdue Fort Wayne",78,"Florida Gulf Coast",85,7
2021-12-04,"Dartmouth",68,"Florida Gulf Coast",78,10
2021-12-19,"Mercer",55,"Florida Gulf Coast",67,12
2022-01-05,"North Florida",67,"Florida Gulf Coast",74,7
2022-01-15,"Liberty",78,"Florida Gulf Coast",75,-3
2022-01-27,"Eastern Kentucky",73,"Florida Gulf Coast",77,4
2022-01-29,"Bellarmine",74,"Florida Gulf Coast",63,-11
2022-02-09,"North Alabama",60,"Florida Gulf Coast",92,32
2022-02-12,"Stetson",82,"Florida Gulf Coast",89,7
2021-11-10,"Penn",70,"Florida St.",105,35
2021-11-17,"Tulane",54,"Florida St.",59,5
2021-11-24,"Boston University",80,"Florida St.",81,1
2021-12-04,"Syracuse",63,"Florida St.",60,-3
2021-12-15,"Lipscomb",60,"Florida St.",97,37
2022-01-08,"Louisville",70,"Florida St.",79,9
2022-01-11,"Miami FL",64,"Florida St.",65,1
2022-01-18,"Duke",78,"Florida St.",79,1
2022-01-20,"North Florida",73,"Florida St.",86,13
2022-01-29,"Virginia Tech",85,"Florida St.",72,-13
2022-02-05,"Wake Forest",68,"Florida St.",60,-8
2022-02-09,"Pittsburgh",56,"Florida St.",51,-5
2021-11-09,"Columbia",67,"Fordham",77,10
2021-11-15,"St. Thomas",78,"Fordham",84,6
2021-11-19,"Maryland Eastern Shore",75,"Fordham",73,-2
2021-11-22,"Akron",43,"Fordham",63,20
2021-11-24,"Rice",74,"Fordham",84,10
2021-12-01,"St. Francis NY",46,"Fordham",68,22
2021-12-09,"LIU",57,"Fordham",73,16
2021-12-12,"Miami FL",72,"Fordham",66,-6
2022-01-12,"Duquesne",71,"Fordham",72,1
2022-01-18,"Richmond",83,"Fordham",70,-13
2022-01-22,"Davidson",69,"Fordham",66,-3
2022-02-02,"Rhode Island",55,"Fordham",61,6
2021-11-09,"Fresno Pacific",54,"Fresno St.",74,20
2021-11-12,"LIU",60,"Fresno St.",84,24
2021-11-15,"Idaho",62,"Fresno St.",69,7
2021-11-22,"Pepperdine",63,"Fresno St.",70,7
2021-12-01,"San Diego",43,"Fresno St.",63,20
2021-12-04,"Cal St. Northridge",43,"Fresno St.",61,18
2021-12-11,"UC Irvine",55,"Fresno St.",63,8
2021-12-17,"Cal Poly",48,"Fresno St.",83,35
2022-01-11,"San Jose St.",59,"Fresno St.",79,20
2022-01-18,"Utah St.",54,"Fresno St.",61,7
2022-01-28,"Boise St.",68,"Fresno St.",63,-5
2022-02-04,"Nevada",56,"Fresno St.",73,17
2022-02-06,"Wyoming",61,"Fresno St.",59,-2
2021-11-09,"North Greenville",66,"Furman",118,52
2021-11-19,"Radford",64,"Furman",81,17
2021-11-21,"Navy",77,"Furman",66,-11
2021-12-03,"Charleston",88,"Furman",91,3
2021-12-10,"Appalachian St.",65,"Furman",73,8
2021-12-21,"Presbyterian",61,"Furman",75,14
2021-12-29,"Samford",49,"Furman",81,32
2022-01-08,"Mercer",66,"Furman",81,15
2022-01-12,"East Tennessee St.",69,"Furman",78,9
2022-01-19,"Western Carolina",50,"Furman",88,38
2022-01-26,"VMI",64,"Furman",79,15
2022-02-02,"The Citadel",83,"Furman",102,19
2022-02-05,"UNC Greensboro",58,"Furman",56,-2
2022-02-12,"Chattanooga",64,"Furman",58,-6
2021-11-20,"Carver",38,"Gardner Webb",100,62
2021-11-24,"Columbia International",78,"Gardner Webb",90,12
2021-11-27,"Western Carolina",59,"Gardner Webb",87,28
2021-11-29,"North Carolina Central",58,"Gardner Webb",83,25
2021-12-08,"Wofford",78,"Gardner Webb",70,-8
2021-12-17,"Converse",46,"Gardner Webb",79,33
2022-01-08,"Hampton",69,"Gardner Webb",78,9
2022-01-12,"Presbyterian",61,"Gardner Webb",64,3
2022-01-19,"USC Upstate",74,"Gardner Webb",61,-13
2022-01-29,"Radford",42,"Gardner Webb",61,19
2022-02-05,"North Carolina A&T",62,"Gardner Webb",69,7
2022-02-12,"Charleston Southern",65,"Gardner Webb",82,17
2021-11-09,"Stony Brook",52,"George Mason",74,22
2021-11-12,"Penn",66,"George Mason",87,21
2021-11-14,"Morgan St.",53,"George Mason",90,37
2021-12-04,"Old Dominion",60,"George Mason",50,-10
2021-12-07,"Navy",65,"George Mason",71,6
2021-12-21,"American",44,"George Mason",67,23
2022-01-22,"Dayton",49,"George Mason",50,1
2022-01-24,"Saint Joseph's",71,"George Mason",77,6
2022-01-26,"St. Bonaventure",66,"George Mason",75,9
2022-02-02,"Saint Louis",92,"George Mason",90,-2
2022-02-09,"Richmond",84,"George Mason",87,3
2022-02-12,"VCU",85,"George Mason",70,-15
2021-11-09,"St. Francis PA",72,"George Washington",75,3
2021-11-19,"UMass Lowell",67,"George Washington",56,-11
2021-11-22,"Wright St.",63,"George Washington",74,11
2021-11-23,"Kent St.",77,"George Washington",69,-8
2021-12-01,"Boston University",56,"George Washington",54,-2
2021-12-08,"Coppin St.",62,"George Washington",75,13
2021-12-13,"Radford",58,"George Washington",67,9
2022-01-08,"Dayton",83,"George Washington",58,-25
2022-01-17,"George Mason",76,"George Washington",77,1
2022-01-30,"Fordham",55,"George Washington",64,9
2022-02-02,"La Salle",87,"George Washington",89,2
2022-02-05,"Davidson",78,"George Washington",73,-5
2021-11-13,"Dartmouth",69,"Georgetown",60,-9
2021-11-16,"American",57,"Georgetown",79,22
2021-11-19,"Siena",65,"Georgetown",83,18
2021-11-26,"Saint Joseph's",77,"Georgetown",74,-3
2021-11-30,"Longwood",83,"Georgetown",91,8
2021-12-08,"UMBC",71,"Georgetown",100,29
2021-12-11,"Syracuse",75,"Georgetown",79,4
2021-12-15,"Howard",73,"Georgetown",85,12
2021-12-18,"TCU",80,"Georgetown",73,-7
2022-01-07,"Marquette",92,"Georgetown",64,-28
2022-01-13,"Butler",72,"Georgetown",58,-14
2022-01-22,"Villanova",85,"Georgetown",74,-11
2022-02-01,"Seton Hall",70,"Georgetown",63,-7
2022-02-03,"St. John's",90,"Georgetown",77,-13
2022-02-06,"Providence",71,"Georgetown",52,-19
2022-02-12,"Creighton",80,"Georgetown",66,-14
2021-11-09,"FIU",51,"Georgia",58,7
2021-11-16,"South Carolina St.",60,"Georgia",76,16
2021-11-19,"Georgia Tech",88,"Georgia",78,-10
2021-11-28,"Wofford",68,"Georgia",65,-3
2021-12-01,"Memphis",79,"Georgia",82,3
2021-12-07,"Jacksonville",58,"Georgia",69,11
2021-12-18,"George Mason",80,"Georgia",67,-13
2021-12-20,"Western Carolina",79,"Georgia",85,6
2021-12-22,"East Tennessee St.",86,"Georgia",84,-2
2021-12-29,"Gardner Webb",77,"Georgia",60,-17
2022-01-04,"Texas A&M",81,"Georgia",79,-2
2022-01-15,"Vanderbilt",73,"Georgia",66,-7
2022-01-25,"Alabama",76,"Georgia",82,6
2022-02-02,"Arkansas",99,"Georgia",73,-26
2022-02-05,"Auburn",74,"Georgia",72,-2
2022-02-12,"South Carolina",80,"Georgia",68,-12
2021-11-09,"Ball St.",71,"Georgia Southern",82,11
2021-11-16,"Bob Jones",51,"Georgia Southern",103,52
2021-12-08,"Carver",43,"Georgia Southern",85,42
2021-12-18,"Covenant",51,"Georgia Southern",85,34
2022-01-08,"UT Arlington",73,"Georgia Southern",74,1
2022-01-20,"Coastal Carolina",76,"Georgia Southern",72,-4
2022-01-22,"Appalachian St.",70,"Georgia Southern",62,-8
2022-02-03,"South Alabama",57,"Georgia Southern",58,1
2022-02-05,"Troy",61,"Georgia Southern",52,-9
2021-11-09,"Brewton Parker",37,"Georgia St.",97,60
2021-11-12,"Northeastern",64,"Georgia St.",83,19
2021-12-06,"Voorhees",51,"Georgia St.",80,29
2021-12-18,"Toccoa Falls",44,"Georgia St.",92,48
2022-01-06,"UT Arlington",70,"Georgia St.",63,-7
2022-01-20,"Appalachian St.",61,"Georgia St.",60,-1
2022-01-22,"Coastal Carolina",72,"Georgia St.",68,-4
2022-02-03,"Troy",67,"Georgia St.",63,-4
2022-02-05,"South Alabama",62,"Georgia St.",69,7
2021-11-09,"Miami OH",72,"Georgia Tech",69,-3
2021-11-12,"Stetson",52,"Georgia Tech",77,25
2021-11-15,"Lamar",66,"Georgia Tech",75,9
2021-11-22,"Charleston Southern",70,"Georgia Tech",85,15
2021-11-26,"Georgia Southern",59,"Georgia Tech",61,2
2021-12-01,"Wisconsin",70,"Georgia Tech",66,-4
2021-12-05,"North Carolina",79,"Georgia Tech",62,-17
2021-12-11,"LSU",69,"Georgia Tech",53,-16
2021-12-21,"Georgia St.",62,"Georgia Tech",72,10
2022-01-02,"Louisville",67,"Georgia Tech",64,-3
2022-01-08,"Notre Dame",72,"Georgia Tech",68,-4
2022-01-19,"Wake Forest",80,"Georgia Tech",64,-16
2022-01-23,"Clayton St.",53,"Georgia Tech",103,50
2022-01-26,"Florida St.",61,"Georgia Tech",75,14
2022-01-29,"Miami FL",73,"Georgia Tech",62,-11
2022-02-05,"Clemson",64,"Georgia Tech",69,5
2021-11-09,"Dixie St.",63,"Gonzaga",97,34
2021-11-13,"Texas",74,"Gonzaga",86,12
2021-11-15,"Alcorn St.",57,"Gonzaga",84,27
2021-11-19,"Bellarmine",50,"Gonzaga",92,42
2021-11-22,"Central Michigan",54,"Gonzaga",107,53
2021-11-23,"UCLA",63,"Gonzaga",83,20
2021-11-29,"Tarleton St.",55,"Gonzaga",64,9
2021-12-04,"Alabama",91,"Gonzaga",82,-9
2021-12-09,"Merrimack",55,"Gonzaga",80,25
2021-12-18,"Texas Tech",55,"Gonzaga",69,14
2021-12-20,"Northern Arizona",49,"Gonzaga",95,46
2021-12-28,"North Alabama",63,"Gonzaga",93,30
2022-01-08,"Pepperdine",83,"Gonzaga",117,34
2022-01-13,"BYU",84,"Gonzaga",110,26
2022-01-20,"San Francisco",62,"Gonzaga",78,16
2022-01-27,"Loyola Marymount",55,"Gonzaga",89,34
2022-01-29,"Portland",72,"Gonzaga",104,32
2022-02-10,"Pacific",51,"Gonzaga",89,38
2022-02-12,"Saint Mary's",58,"Gonzaga",74,16
2021-11-24,"Louisiana College",61,"Grambling St.",71,10
2021-11-28,"Morgan St.",59,"Grambling St.",74,15
2021-11-29,"Norfolk St.",70,"Grambling St.",63,-7
2021-12-02,"Jarvis Christian",44,"Grambling St.",71,27
2022-01-05,"Texas Southern",67,"Grambling St.",61,-6
2022-01-15,"Southern",77,"Grambling St.",83,6
2022-01-22,"Mississippi Valley St.",64,"Grambling St.",68,4
2022-01-24,"Arkansas Pine Bluff",65,"Grambling St.",76,11
2022-02-05,"Alabama St.",80,"Grambling St.",72,-8
2022-02-07,"Alabama A&M",50,"Grambling St.",58,8
2021-11-09,"Grambling St.",53,"Grand Canyon",74,21
2021-11-12,"North Florida",51,"Grand Canyon",65,14
2021-11-17,"Prairie View A&M",64,"Grand Canyon",91,27
2021-11-22,"Wyoming",68,"Grand Canyon",61,-7
2021-11-24,"Life Pacific",47,"Grand Canyon",82,35
2021-12-02,"UTSA",71,"Grand Canyon",74,3
2021-12-04,"Mississippi Valley St.",44,"Grand Canyon",91,47
2021-12-11,"Ottawa AZ",53,"Grand Canyon",81,28
2021-12-18,"San Francisco",48,"Grand Canyon",49,1
2021-12-30,"Chicago St.",63,"Grand Canyon",80,17
2022-01-13,"Abilene Christian",68,"Grand Canyon",95,27
2022-01-15,"Tarleton St.",59,"Grand Canyon",80,21
2022-02-03,"Seattle",66,"Grand Canyon",78,12
2022-02-05,"Cal Baptist",50,"Grand Canyon",56,6
2021-11-09,"Indiana St.",81,"Green Bay",77,-4
2021-11-18,"UNC Greensboro",60,"Green Bay",58,-2
2021-11-19,"FIU",63,"Green Bay",60,-3
2021-11-27,"Wisconsin Superior",48,"Green Bay",77,29
2021-12-02,"Robert Morris",58,"Green Bay",70,12
2021-12-04,"Youngstown St.",82,"Green Bay",58,-24
2022-01-05,"Milwaukee",63,"Green Bay",49,-14
2022-01-13,"IUPUI",54,"Green Bay",69,15
2022-01-15,"Illinois Chicago",80,"Green Bay",63,-17
2022-01-20,"Detroit Mercy",63,"Green Bay",70,7
2022-01-22,"Oakland",68,"Green Bay",61,-7
2022-02-09,"Wright St.",79,"Green Bay",62,-17
2022-02-11,"Northern Kentucky",71,"Green Bay",62,-9
2021-11-09,"Mid Atlantic Christian",51,"Hampton",101,50
2021-11-13,"Regent",56,"Hampton",70,14
2021-11-20,"Georgia Southern",86,"Hampton",66,-20
2021-11-28,"Norfolk St.",70,"Hampton",61,-9
2021-11-29,"Morgan St.",60,"Hampton",47,-13
2021-12-04,"Norfolk St.",57,"Hampton",58,1
2022-01-22,"High Point",64,"Hampton",68,4
2022-01-24,"Longwood",73,"Hampton",49,-24
2022-02-02,"USC Upstate",85,"Hampton",78,-7
2022-02-05,"Winthrop",69,"Hampton",57,-12
2022-02-07,"Presbyterian",69,"Hampton",74,5
2022-02-12,"Radford",60,"Hampton",54,-6
2021-11-18,"Boston University",75,"Hartford",70,-5
2021-12-14,"St. Francis PA",81,"Hartford",66,-15
2022-01-19,"New Hampshire",57,"Hartford",69,12
2022-01-26,"Binghamton",60,"Hartford",72,12
2022-02-05,"Albany",71,"Hartford",52,-19
2021-11-09,"Morehouse",70,"Harvard",86,16
2021-11-20,"MIT",52,"Harvard",98,46
2021-11-24,"Colgate",84,"Harvard",89,5
2021-11-27,"Northeastern",57,"Harvard",77,20
2021-12-01,"Rhode Island",64,"Harvard",57,-7
2021-12-06,"Babson",64,"Harvard",74,10
2021-12-19,"Holy Cross",54,"Harvard",62,8
2021-12-21,"Howard",69,"Harvard",77,8
2022-01-07,"Brown",84,"Harvard",73,-11
2022-01-28,"Penn",78,"Harvard",74,-4
2022-02-09,"Yale",62,"Harvard",59,-3
2021-11-10,"Hawaii Hilo",67,"Hawaii",97,30
2021-11-11,"Northern Colorado",81,"Hawaii",78,-3
2021-11-13,"Pacific",61,"Hawaii",73,12
2021-11-25,"Illinois Chicago",80,"Hawaii",88,8
2021-11-26,"South Alabama",72,"Hawaii",69,-3
2021-12-08,"Hawaii Pacific",52,"Hawaii",88,36
2021-12-22,"Vanderbilt",68,"Hawaii",54,-14
2021-12-23,"South Florida",76,"Hawaii",69,-7
2022-01-13,"UC Irvine",56,"Hawaii",72,16
2022-01-15,"UC San Diego",56,"Hawaii",79,23
2022-01-27,"Cal St. Northridge",65,"Hawaii",72,7
2022-01-29,"UC Santa Barbara",62,"Hawaii",65,3
2022-02-10,"Long Beach St.",73,"Hawaii",66,-7
2022-02-12,"Cal St. Fullerton",55,"Hawaii",72,17
2021-11-13,"Northern Colorado",79,"Hawaii-Hilo",87,8
2021-11-09,"Shenandoah",59,"High Point",108,49
2021-11-20,"Howard",63,"High Point",73,10
2021-11-21,"Georgia St.",74,"High Point",66,-8
2021-11-27,"Chowan",60,"High Point",90,30
2021-11-30,"Furman",74,"High Point",70,-4
2021-12-07,"Guilford",59,"High Point",64,5
2021-12-18,"UNC Wilmington",71,"High Point",69,-2
2021-12-21,"Florida Atlantic",52,"High Point",55,3
2022-01-15,"North Carolina A&T",71,"High Point",78,7
2022-01-24,"Winthrop",56,"High Point",65,9
2022-01-26,"Radford",58,"High Point",63,5
2022-02-02,"Gardner Webb",65,"High Point",57,-8
2022-02-05,"UNC Asheville",83,"High Point",91,8
2022-02-12,"Campbell",60,"High Point",42,-18
2021-11-24,"Molloy",49,"Hofstra",87,38
2021-11-27,"Detroit Mercy",84,"Hofstra",98,14
2021-12-01,"Princeton",77,"Hofstra",81,4
2021-12-04,"Bucknell",69,"Hofstra",88,19
2021-12-12,"John Jay",51,"Hofstra",102,51
2022-01-15,"Delaware",77,"Hofstra",82,5
2022-01-17,"Drexel",68,"Hofstra",71,3
2022-02-03,"Towson",78,"Hofstra",68,-10
2022-02-05,"James Madison",78,"Hofstra",85,7
2022-02-07,"UNC Wilmington",71,"Hofstra",73,2
2021-11-09,"Regis MA",51,"Holy Cross",98,47
2021-11-20,"Air Force",72,"Holy Cross",53,-19
2021-11-21,"Bryant",78,"Holy Cross",62,-16
2021-11-24,"Mount Saint Vincent",52,"Holy Cross",95,43
2021-11-27,"New Hampshire",70,"Holy Cross",55,-15
2021-12-11,"Siena",72,"Holy Cross",59,-13
2022-01-01,"Navy",70,"Holy Cross",56,-14
2022-01-07,"Lafayette",74,"Holy Cross",79,5
2022-01-22,"Bucknell",68,"Holy Cross",65,-3
2022-01-28,"Lehigh",65,"Holy Cross",67,2
2022-02-09,"Loyola MD",64,"Holy Cross",68,4
2021-11-09,"Hofstra",75,"Houston",83,8
2021-11-12,"Rice",46,"Houston",79,33
2021-11-16,"Virginia",47,"Houston",67,20
2021-11-22,"Butler",52,"Houston",70,18
2021-11-23,"Wisconsin",65,"Houston",63,-2
2021-11-30,"Northwestern St.",58,"Houston",99,41
2021-12-03,"Bryant",44,"Houston",111,67
2021-12-06,"Alcorn St.",45,"Houston",77,32
2021-12-14,"Louisiana",56,"Houston",71,15
2021-12-22,"Texas St.",47,"Houston",80,33
2022-01-08,"Wichita St.",66,"Houston",76,10
2022-01-18,"South Florida",55,"Houston",74,19
2022-01-22,"East Carolina",36,"Houston",79,43
2022-02-02,"Tulane",62,"Houston",73,11
2022-02-12,"Memphis",69,"Houston",59,-10
2021-11-13,"Barclay",44,"Houston Baptist",122,78
2021-11-29,"Southwestern Adventist",62,"Houston Baptist",100,38
2021-12-04,"Oral Roberts",85,"Houston Baptist",67,-18
2021-12-07,"Champion Christian",67,"Houston Baptist",84,17
2021-12-11,"Rice",88,"Houston Baptist",73,-15
2022-01-03,"Ecclesia",63,"Houston Baptist",94,31
2022-01-06,"Southeastern Louisiana",90,"Houston Baptist",81,-9
2022-01-27,"New Orleans",77,"Houston Baptist",66,-11
2022-01-29,"Nicholls St.",73,"Houston Baptist",61,-12
2022-02-03,"Northwestern St.",97,"Houston Baptist",87,-10
2022-02-05,"Southeastern Louisiana",80,"Houston Baptist",93,13
2021-11-09,"District of Columbia",59,"Howard",87,28
2021-11-10,"Regent",54,"Howard",118,64
2021-11-26,"Austin Peay",69,"Howard",67,-2
2021-12-04,"American",56,"Howard",90,34
2021-12-18,"North Carolina A&T",57,"Howard",79,22
2022-01-15,"Norfolk St.",77,"Howard",74,-3
2022-01-17,"Notre Dame",71,"Howard",68,-3
2022-02-05,"Maryland Eastern Shore",64,"Howard",72,8
2022-02-08,"Gallaudet",38,"Howard",96,58
2022-02-12,"Delaware St.",72,"Howard",85,13
2021-11-10,"Long Beach St.",95,"Idaho",89,-6
2021-11-12,"George Fox",85,"Idaho",95,10
2021-11-18,"Washington St.",109,"Idaho",61,-48
2021-11-22,"Utah Valley",83,"Idaho",45,-38
2021-11-24,"Cal Poly",67,"Idaho",63,-4
2021-12-04,"Southern Utah",81,"Idaho",75,-6
2021-12-08,"South Dakota St.",84,"Idaho",98,14
2021-12-18,"American Indian",55,"Idaho",84,29
2022-01-06,"Montana St.",92,"Idaho",72,-20
2022-01-20,"Northern Colorado",87,"Idaho",70,-17
2022-01-22,"Sacramento St.",72,"Idaho",73,1
2022-02-10,"Idaho St.",79,"Idaho",70,-9
2022-02-12,"Weber St.",79,"Idaho",83,4
2021-11-09,"Eastern Oregon",61,"Idaho St.",82,21
2021-11-22,"UMKC",74,"Idaho St.",58,-16
2021-12-02,"Portland St.",63,"Idaho St.",55,-8
2021-12-04,"Northern Arizona",73,"Idaho St.",70,-3
2021-12-18,"Bethesda",68,"Idaho St.",103,35
2022-01-15,"Idaho",74,"Idaho St.",81,7
2022-01-17,"Weber St.",78,"Idaho St.",61,-17
2022-01-24,"Eastern Washington",89,"Idaho St.",63,-26
2022-02-05,"Montana",63,"Idaho St.",86,23
2022-02-07,"Montana St.",72,"Idaho St.",54,-18
2021-11-09,"Jackson St.",47,"Illinois",71,24
2021-11-12,"Arkansas St.",53,"Illinois",92,39
2021-11-22,"Cincinnati",71,"Illinois",51,-20
2021-11-26,"UT Rio Grande Valley",85,"Illinois",94,9
2021-11-29,"Notre Dame",72,"Illinois",82,10
2021-12-03,"Rutgers",51,"Illinois",86,35
2021-12-11,"Arizona",83,"Illinois",79,-4
2021-12-18,"St. Francis PA",48,"Illinois",106,58
2022-01-06,"Maryland",64,"Illinois",76,12
2022-01-14,"Michigan",53,"Illinois",68,15
2022-01-17,"Purdue",96,"Illinois",88,-8
2022-01-25,"Michigan St.",55,"Illinois",56,1
2022-02-02,"Wisconsin",67,"Illinois",80,13
2021-11-16,"Trinity Christian",50,"Illinois Chicago",91,41
2021-11-26,"San Diego",64,"Illinois Chicago",52,-12
2021-12-02,"Oakland",81,"Illinois Chicago",77,-4
2021-12-05,"Detroit Mercy",64,"Illinois Chicago",56,-8
2021-12-14,"DePaul",72,"Illinois Chicago",66,-6
2021-12-19,"Northern Illinois",60,"Illinois Chicago",61,1
2022-01-20,"Northern Kentucky",74,"Illinois Chicago",70,-4
2022-01-22,"Wright St.",97,"Illinois Chicago",81,-16
2022-02-03,"Robert Morris",75,"Illinois Chicago",80,5
2022-02-05,"Youngstown St.",66,"Illinois Chicago",64,-2
2021-11-09,"UNC Wilmington",63,"Illinois St.",68,5
2021-11-16,"Murray St.",77,"Illinois St.",65,-12
2021-11-20,"Bucknell",100,"Illinois St.",105,5
2021-11-24,"Buffalo",106,"Illinois St.",90,-16
2021-11-27,"Purdue Northwest",71,"Illinois St.",81,10
2021-12-01,"Missouri St.",74,"Illinois St.",79,5
2021-12-04,"Jackson St.",61,"Illinois St.",55,-6
2021-12-14,"Quincy",63,"Illinois St.",81,18
2021-12-18,"Ball St.",64,"Illinois St.",85,21
2021-12-21,"UTSA",64,"Illinois St.",81,17
2022-01-16,"Bradley",65,"Illinois St.",74,9
2022-01-21,"Evansville",56,"Illinois St.",94,38
2022-01-26,"Drake",89,"Illinois St.",88,-1
2022-02-05,"Southern Illinois",75,"Illinois St.",69,-6
2022-02-09,"Valparaiso",75,"Illinois St.",78,3
2021-11-09,"Texas St.",75,"Incarnate Word",57,-18
2021-11-16,"Concordia TX",82,"Incarnate Word",78,-4
2021-11-26,"Southeast Missouri St.",79,"Incarnate Word",76,-3
2021-11-27,"Montana St.",83,"Incarnate Word",64,-19
2021-11-28,"Portland",77,"Incarnate Word",68,-9
2021-12-01,"Our Lady of the Lake",66,"Incarnate Word",93,27
2021-12-11,"Grambling St.",62,"Incarnate Word",72,10
2022-01-02,"Dallas Christian",45,"Incarnate Word",90,45
2022-01-06,"Nicholls St.",87,"Incarnate Word",56,-31
2022-01-07,"Northwestern St.",83,"Incarnate Word",80,-3
2022-01-08,"Houston Baptist",50,"Incarnate Word",60,10
2022-01-20,"Houston Baptist",68,"Incarnate Word",65,-3
2022-01-22,"McNeese St.",82,"Incarnate Word",72,-10
2022-02-03,"Nicholls St.",63,"Incarnate Word",60,-3
2022-02-05,"New Orleans",70,"Incarnate Word",78,8
2021-11-09,"Eastern Michigan",62,"Indiana",68,6
2021-11-12,"Northern Illinois",49,"Indiana",85,36
2021-11-17,"St. John's",74,"Indiana",76,2
2021-11-21,"Louisiana",44,"Indiana",76,32
2021-11-23,"Jackson St.",35,"Indiana",70,35
2021-11-27,"Marshall",79,"Indiana",90,11
2021-12-04,"Nebraska",55,"Indiana",68,13
2021-12-12,"Merrimack",49,"Indiana",81,32
2021-12-18,"Notre Dame",56,"Indiana",64,8
2021-12-22,"Northern Kentucky",61,"Indiana",79,18
2022-01-06,"Ohio St.",51,"Indiana",67,16
2022-01-09,"Minnesota",60,"Indiana",73,13
2022-01-20,"Purdue",65,"Indiana",68,3
2022-01-23,"Michigan",80,"Indiana",62,-18
2022-01-26,"Penn St.",57,"Indiana",74,17
2022-02-05,"Illinois",74,"Indiana",57,-17
2021-11-14,"Hanover",49,"Indiana St.",90,41
2021-11-19,"Oklahoma",87,"Indiana St.",63,-24
2021-11-21,"New Mexico St.",80,"Indiana St.",66,-14
2021-12-04,"Miami OH",68,"Indiana St.",69,1
2021-12-18,"Alabama A&M",43,"Indiana St.",67,24
2021-12-20,"Oakland City",69,"Indiana St.",78,9
2021-12-29,"Midway",51,"Indiana St.",107,56
2022-01-02,"Bradley",71,"Indiana St.",76,5
2022-01-15,"Loyola Chicago",64,"Indiana St.",56,-8
2022-01-22,"Valparaiso",75,"Indiana St.",73,-2
2022-01-25,"Missouri St.",72,"Indiana St.",76,4
2022-02-02,"Drake",85,"Indiana St.",67,-18
2022-02-08,"Evansville",65,"Indiana St.",56,-9
2022-02-12,"Illinois St.",57,"Indiana St.",60,3
2021-11-09,"Appalachian St.",53,"Iona",65,12
2021-11-13,"Harvard",87,"Iona",90,3
2021-11-16,"Hofstra",74,"Iona",82,8
2021-11-20,"North Alabama",65,"Iona",81,16
2021-11-25,"Alabama",68,"Iona",72,4
2021-11-28,"Kansas",96,"Iona",83,-13
2021-12-03,"Rider",54,"Iona",80,26
2021-12-12,"Yale",77,"Iona",91,14
2021-12-21,"Delaware",72,"Iona",83,11
2022-01-02,"Marist",66,"Iona",69,3
2022-01-14,"Manhattan",76,"Iona",88,12
2022-01-16,"Niagara",55,"Iona",78,23
2022-01-25,"Siena",57,"Iona",74,17
2022-01-30,"Saint Peter's",77,"Iona",85,8
2021-11-09,"Longwood",73,"Iowa",106,33
2021-11-12,"UMKC",57,"Iowa",89,32
2021-11-16,"North Carolina Central",69,"Iowa",86,17
2021-11-18,"Alabama St.",82,"Iowa",108,26
2021-11-22,"Western Michigan",61,"Iowa",109,48
2021-11-26,"Portland St.",51,"Iowa",85,34
2021-12-06,"Illinois",87,"Iowa",83,-4
2021-12-18,"Utah St.",75,"Iowa",94,19
2021-12-21,"Southeastern Louisiana",62,"Iowa",93,31
2021-12-29,"Western Illinois",71,"Iowa",92,21
2022-01-03,"Maryland",75,"Iowa",80,5
2022-01-13,"Indiana",74,"Iowa",83,9
2022-01-22,"Penn St.",51,"Iowa",68,17
2022-01-27,"Purdue",83,"Iowa",73,-10
2022-02-06,"Minnesota",59,"Iowa",71,12
2021-11-09,"Kennesaw St.",73,"Iowa St.",84,11
2021-11-12,"Oregon St.",50,"Iowa St.",60,10
2021-11-16,"Alabama St.",60,"Iowa St.",68,8
2021-11-21,"Grambling St.",47,"Iowa St.",82,35
2021-12-01,"Arkansas Pine Bluff",64,"Iowa St.",83,19
2021-12-09,"Iowa",53,"Iowa St.",73,20
2021-12-12,"Jackson St.",37,"Iowa St.",47,10
2021-12-19,"Southeastern Louisiana",54,"Iowa St.",77,23
2021-12-21,"Chicago St.",48,"Iowa St.",79,31
2022-01-01,"Baylor",77,"Iowa St.",72,-5
2022-01-05,"Texas Tech",47,"Iowa St.",51,4
2022-01-15,"Texas",70,"Iowa St.",79,9
2022-01-22,"TCU",59,"Iowa St.",44,-15
2022-01-29,"Missouri",50,"Iowa St.",67,17
2022-02-01,"Kansas",70,"Iowa St.",61,-9
2022-02-12,"Kansas St.",75,"Iowa St.",69,-6
2021-11-15,"Denver",63,"IUPUI",47,-16
2021-11-16,"Texas A&M Corpus Chris",65,"IUPUI",59,-6
2021-11-23,"Spalding",41,"IUPUI",61,20
2021-12-02,"Detroit Mercy",69,"IUPUI",45,-24
2021-12-04,"Oakland",78,"IUPUI",45,-33
2021-12-16,"Chicago St.",61,"IUPUI",55,-6
2021-12-21,"Morehead St.",80,"IUPUI",52,-28
2022-01-10,"Illinois Chicago",67,"IUPUI",65,-2
2022-01-20,"Wright St.",73,"IUPUI",45,-28
2022-01-22,"Northern Kentucky",60,"IUPUI",41,-19
2022-01-31,"East West",59,"IUPUI",75,16
2022-02-03,"Youngstown St.",61,"IUPUI",55,-6
2022-02-05,"Robert Morris",66,"IUPUI",49,-17
2022-01-05,"Alcorn St.",65,"Jackson St.",50,-15
2022-01-15,"Prairie View A&M",64,"Jackson St.",75,11
2022-01-17,"Texas Southern",58,"Jackson St.",61,3
2022-01-29,"Grambling St.",73,"Jackson St.",64,-9
2022-01-31,"Southern",75,"Jackson St.",64,-11
2022-02-12,"Florida A&M",56,"Jackson St.",60,4
2021-11-09,"Trinity Baptist",43,"Jacksonville",79,36
2021-11-13,"North Carolina A&T",54,"Jacksonville",63,9
2021-11-27,"Coastal Georgia",54,"Jacksonville",83,29
2021-12-11,"UNC Wilmington",48,"Jacksonville",77,29
2021-12-18,"Webber International",48,"Jacksonville",87,39
2021-12-29,"Carver",45,"Jacksonville",98,53
2022-01-08,"Florida Gulf Coast",66,"Jacksonville",69,3
2022-01-11,"Stetson",50,"Jacksonville",57,7
2022-01-27,"Lipscomb",59,"Jacksonville",66,7
2022-01-29,"Central Arkansas",59,"Jacksonville",79,20
2022-02-09,"Eastern Kentucky",68,"Jacksonville",81,13
2022-02-12,"Liberty",69,"Jacksonville",73,4
2021-11-13,"Alabama A&M",47,"Jacksonville St.",70,23
2021-11-22,"Valparaiso",78,"Jacksonville St.",70,-8
2021-11-24,"Drexel",64,"Jacksonville St.",72,8
2021-12-04,"South Alabama",74,"Jacksonville St.",64,-10
2021-12-13,"LaGrange",80,"Jacksonville St.",110,30
2021-12-15,"FIU",59,"Jacksonville St.",66,7
2021-12-28,"Carver",59,"Jacksonville St.",123,64
2022-01-11,"Lipscomb",83,"Jacksonville St.",88,5
2022-01-22,"Florida Gulf Coast",71,"Jacksonville St.",79,8
2022-01-24,"Bellarmine",60,"Jacksonville St.",65,5
2022-02-03,"North Florida",88,"Jacksonville St.",76,-12
2022-02-05,"Jacksonville",58,"Jacksonville St.",64,6
2022-02-12,"Central Arkansas",72,"Jacksonville St.",62,-10
2021-11-10,"Carlow",40,"James Madison",135,95
2021-11-13,"Old Dominion",53,"James Madison",58,5
2021-11-19,"George Mason",64,"James Madison",67,3
2021-11-22,"Kent St.",74,"James Madison",69,-5
2021-12-02,"Eastern Mennonite",54,"James Madison",96,42
2021-12-07,"Virginia",49,"James Madison",52,3
2021-12-11,"Radford",70,"James Madison",79,9
2022-01-09,"Hofstra",87,"James Madison",80,-7
2022-01-11,"Northeastern",66,"James Madison",89,23
2022-01-20,"UNC Wilmington",71,"James Madison",70,-1
2022-01-22,"Charleston",94,"James Madison",95,1
2022-01-27,"Drexel",88,"James Madison",82,-6
2022-01-29,"Delaware",85,"James Madison",69,-16
2022-02-10,"Elon",70,"James Madison",66,-4
2022-02-12,"William & Mary",55,"James Madison",69,14
2021-11-12,"Tarleton St.",62,"Kansas",88,26
2021-11-18,"Stony Brook",59,"Kansas",88,29
2021-11-25,"North Texas",59,"Kansas",71,12
2021-11-26,"Dayton",74,"Kansas",73,-1
2021-12-07,"UTEP",52,"Kansas",78,26
2021-12-11,"Missouri",65,"Kansas",102,37
2021-12-18,"Stephen F. Austin",72,"Kansas",80,8
2021-12-29,"Nevada",61,"Kansas",88,27
2022-01-01,"George Mason",67,"Kansas",76,9
2022-01-11,"Iowa St.",61,"Kansas",62,1
2022-01-15,"West Virginia",59,"Kansas",85,26
2022-01-24,"Texas Tech",91,"Kansas",94,3
2022-01-29,"Kentucky",80,"Kansas",62,-18
2022-02-05,"Baylor",59,"Kansas",83,24
2022-02-12,"Oklahoma",69,"Kansas",71,2
2021-11-10,"Florida A&M",57,"Kansas St.",67,10
2021-11-17,"Nebraska Omaha",64,"Kansas St.",79,15
2021-11-22,"Arkansas",72,"Kansas St.",64,-8
2021-11-23,"Illinois",72,"Kansas St.",64,-8
2021-11-28,"North Dakota",42,"Kansas St.",84,42
2021-12-01,"Albany",43,"Kansas St.",71,28
2021-12-08,"Marquette",64,"Kansas St.",63,-1
2021-12-12,"Green Bay",64,"Kansas St.",82,18
2021-12-21,"McNeese St.",59,"Kansas St.",74,15
2022-01-04,"Texas",70,"Kansas St.",57,-13
2022-01-12,"TCU",60,"Kansas St.",57,-3
2022-01-15,"Texas Tech",51,"Kansas St.",62,11
2022-01-22,"Kansas",78,"Kansas St.",75,-3
2022-02-02,"Oklahoma St.",68,"Kansas St.",71,3
2022-02-09,"Baylor",75,"Kansas St.",60,-15
2021-11-14,"Piedmont",57,"Kennesaw St.",81,24
2021-11-15,"Carver",58,"Kennesaw St.",117,59
2021-11-19,"Belmont",97,"Kennesaw St.",78,-19
2021-11-28,"Charleston Southern",52,"Kennesaw St.",89,37
2021-12-01,"Mercer",73,"Kennesaw St.",71,-2
2021-12-11,"Voorhees",56,"Kennesaw St.",80,24
2021-12-30,"Toccoa Falls",51,"Kennesaw St.",108,57
2022-01-13,"Florida Gulf Coast",53,"Kennesaw St.",77,24
2022-01-24,"Jacksonville",68,"Kennesaw St.",76,8
2022-01-27,"Jacksonville St.",70,"Kennesaw St.",64,-6
2022-01-29,"North Alabama",71,"Kennesaw St.",58,-13
2022-01-31,"Liberty",65,"Kennesaw St.",50,-15
2022-02-09,"Central Arkansas",72,"Kennesaw St.",83,11
2022-02-12,"North Florida",74,"Kennesaw St.",72,-2
2021-11-16,"Oberlin",38,"Kent St.",84,46
2021-11-30,"Point Park",41,"Kent St.",107,66
2021-12-06,"Towson",73,"Kent St.",58,-15
2021-12-09,"Detroit Mercy",52,"Kent St.",69,17
2021-12-19,"Southern",78,"Kent St.",76,-2
2021-12-29,"Central Michigan",72,"Kent St.",69,-3
2022-01-01,"Toledo",63,"Kent St.",66,3
2022-01-11,"Northern Illinois",65,"Kent St.",63,-2
2022-01-14,"Akron",55,"Kent St.",67,12
2022-01-25,"Western Michigan",64,"Kent St.",75,11
2022-02-05,"Eastern Michigan",71,"Kent St.",90,19
2022-02-08,"Bowling Green",68,"Kent St.",76,8
2021-11-12,"Robert Morris",60,"Kentucky",100,40
2021-11-16,"Mount St. Mary's",55,"Kentucky",80,25
2021-11-19,"Ohio",59,"Kentucky",77,18
2021-11-22,"Albany",61,"Kentucky",86,25
2021-11-26,"North Florida",52,"Kentucky",86,34
2021-11-29,"Central Michigan",57,"Kentucky",85,28
2021-12-07,"Southern",64,"Kentucky",76,12
2021-12-18,"North Carolina",69,"Kentucky",98,29
2021-12-22,"Western Kentucky",60,"Kentucky",95,35
2021-12-29,"Missouri",56,"Kentucky",83,27
2021-12-31,"High Point",48,"Kentucky",92,44
2022-01-08,"Georgia",77,"Kentucky",92,15
2022-01-15,"Tennessee",79,"Kentucky",107,28
2022-01-25,"Mississippi St.",74,"Kentucky",82,8
2022-02-02,"Vanderbilt",70,"Kentucky",77,7
2022-02-12,"Florida",57,"Kentucky",78,21
2021-11-09,"Sacred Heart",86,"La Salle",81,-5
2021-11-13,"Albany",64,"La Salle",67,3
2021-11-20,"Army",58,"La Salle",61,3
2021-11-28,"Villanova",72,"La Salle",46,-26
2021-12-04,"Holy Cross",65,"La Salle",84,19
2021-12-07,"Fairleigh Dickinson",55,"La Salle",81,26
2021-12-11,"Penn",74,"La Salle",76,2
2021-12-30,"Fordham",69,"La Salle",61,-8
2022-01-08,"VCU",85,"La Salle",66,-19
2022-01-11,"St. Bonaventure",80,"La Salle",76,-4
2022-01-22,"Richmond",64,"La Salle",56,-8
2022-01-26,"Massachusetts",77,"La Salle",71,-6
2022-02-05,"George Mason",78,"La Salle",83,5
2022-02-08,"Saint Louis",75,"La Salle",57,-18
2021-11-12,"Cornell",90,"Lafayette",85,-5
2021-12-02,"Sacred Heart",74,"Lafayette",67,-7
2021-12-05,"NJIT",90,"Lafayette",86,-4
2021-12-11,"Princeton",84,"Lafayette",73,-11
2021-12-22,"Gwynedd Mercy",66,"Lafayette",87,21
2022-01-10,"Navy",69,"Lafayette",55,-14
2022-01-16,"Army",54,"Lafayette",68,14
2022-01-26,"Boston University",81,"Lafayette",62,-19
2022-01-31,"Colgate",72,"Lafayette",61,-11
2022-02-02,"American",62,"Lafayette",71,9
2022-02-05,"Bucknell",72,"Lafayette",74,2
2021-11-09,"Wiley",50,"Lamar",67,17
2021-11-19,"Stetson",60,"Lamar",59,-1
2021-12-05,"Our Lady of the Lake",64,"Lamar",67,3
2021-12-20,"Louisiana Monroe",80,"Lamar",77,-3
2022-01-13,"Sam Houston St.",73,"Lamar",56,-17
2022-01-15,"Chicago St.",67,"Lamar",56,-11
2022-01-26,"Tarleton St.",62,"Lamar",57,-5
2022-01-29,"Abilene Christian",85,"Lamar",82,-3
2021-11-13,"NJIT",73,"Lehigh",56,-17
2021-11-23,"Columbia",72,"Lehigh",79,7
2021-11-28,"St. Francis PA",79,"Lehigh",68,-11
2021-12-04,"Maryland Eastern Shore",81,"Lehigh",75,-6
2021-12-21,"Albany",68,"Lehigh",52,-16
2021-12-29,"Eastern",63,"Lehigh",70,7
2022-01-04,"Colgate",81,"Lehigh",85,4
2022-01-10,"Holy Cross",69,"Lehigh",77,8
2022-01-16,"Loyola MD",69,"Lehigh",57,-12
2022-01-26,"Army",71,"Lehigh",84,13
2022-02-02,"Navy",62,"Lehigh",63,1
2022-02-05,"Boston University",80,"Lehigh",74,-6
2022-02-12,"Lafayette",73,"Lehigh",69,-4
2021-11-11,"Regent",24,"Liberty",85,61
2021-11-19,"Iona",54,"Liberty",50,-4
2021-11-27,"Maryland Eastern Shore",61,"Liberty",73,12
2021-12-02,"Missouri",45,"Liberty",66,21
2021-12-06,"Delaware St.",60,"Liberty",96,36
2021-12-13,"Carver",36,"Liberty",95,59
2021-12-31,"Boyce",60,"Liberty",91,31
2022-01-11,"North Florida",56,"Liberty",71,15
2022-01-18,"Jacksonville",49,"Liberty",88,39
2022-01-27,"North Alabama",53,"Liberty",72,19
2022-01-29,"Jacksonville St.",77,"Liberty",67,-10
2022-02-08,"Lipscomb",69,"Liberty",78,9
2021-11-09,"Birmingham Southern",98,"Lipscomb",105,7
2021-11-28,"Kentucky Christian",67,"Lipscomb",86,19
2021-12-05,"Chattanooga",85,"Lipscomb",64,-21
2021-12-12,"Tennessee St.",73,"Lipscomb",65,-8
2021-12-19,"Tennessee Wesleyan",64,"Lipscomb",98,34
2021-12-30,"Alabama A&M",63,"Lipscomb",66,3
2022-01-04,"North Alabama",74,"Lipscomb",84,10
2022-01-15,"Bellarmine",77,"Lipscomb",71,-6
2022-01-22,"Kennesaw St.",73,"Lipscomb",77,4
2022-02-03,"Stetson",77,"Lipscomb",71,-6
2022-02-05,"Florida Gulf Coast",77,"Lipscomb",68,-9
2022-02-12,"Eastern Kentucky",73,"Lipscomb",83,10
2021-11-09,"Southern Illinois",66,"Little Rock",69,3
2021-11-12,"Champion Christian",51,"Little Rock",115,64
2021-11-14,"Arkansas Baptist",60,"Little Rock",91,31
2021-11-22,"Northern Illinois",60,"Little Rock",67,7
2021-12-08,"Missouri St.",81,"Little Rock",55,-26
2021-12-11,"Philander Smith",51,"Little Rock",60,9
2021-12-21,"Jacksonville St.",87,"Little Rock",67,-20
2021-12-30,"Georgia Southern",66,"Little Rock",78,12
2022-01-20,"Texas St.",69,"Little Rock",59,-10
2022-01-22,"UT Arlington",96,"Little Rock",98,2
2022-02-03,"Louisiana",75,"Little Rock",51,-24
2022-02-05,"Louisiana Monroe",75,"Little Rock",72,-3
2021-11-27,"Delaware St.",65,"LIU",99,34
2021-12-13,"US Merchant Marine",48,"LIU",106,58
2021-12-19,"Army",65,"LIU",90,25
2022-01-06,"Mount St. Mary's",57,"LIU",74,17
2022-01-08,"St. Francis PA",70,"LIU",75,5
2022-01-15,"Central Connecticut",61,"LIU",83,22
2022-01-21,"Wagner",92,"LIU",85,-7
2022-02-03,"Sacred Heart",75,"LIU",79,4
2022-02-10,"St. Francis NY",69,"LIU",74,5
2022-02-12,"Bryant",88,"LIU",99,11
2021-11-17,"Utah Valley",84,"Long Beach St.",78,-6
2021-11-22,"Missouri St.",92,"Long Beach St.",66,-26
2021-11-23,"Murray St.",80,"Long Beach St.",43,-37
2021-11-24,"Wright St.",76,"Long Beach St.",85,9
2021-12-04,"Loyola Marymount",77,"Long Beach St.",74,-3
2021-12-08,"Bethesda",69,"Long Beach St.",102,33
2022-01-05,"Westcliff",64,"Long Beach St.",90,26
2022-01-08,"Hawaii",72,"Long Beach St.",67,-5
2022-01-13,"UC Santa Barbara",58,"Long Beach St.",65,7
2022-01-15,"Cal St. Northridge",55,"Long Beach St.",71,16
2022-01-22,"UC Irvine",67,"Long Beach St.",73,6
2022-02-03,"Cal St. Bakersfield",65,"Long Beach St.",74,9
2022-02-05,"Cal Poly",65,"Long Beach St.",78,13
2022-02-08,"Cal St. Fullerton",61,"Long Beach St.",71,10
2021-11-12,"Virginia Lynchburg",46,"Longwood",80,34
2021-11-14,"Mid Atlantic Christian",47,"Longwood",93,46
2021-11-19,"American",42,"Longwood",82,40
2021-11-20,"UMBC",55,"Longwood",82,27
2021-11-21,"Western Carolina",64,"Longwood",53,-11
2021-12-04,"Delaware St.",58,"Longwood",78,20
2021-12-11,"Morgan St.",55,"Longwood",94,39
2021-12-14,"Carolina",56,"Longwood",98,42
2022-01-05,"Pfeiffer",69,"Longwood",109,40
2022-01-15,"Gardner Webb",60,"Longwood",66,6
2022-01-19,"Campbell",64,"Longwood",72,8
2022-01-26,"North Carolina A&T",71,"Longwood",79,8
2022-01-29,"Winthrop",88,"Longwood",92,4
2022-02-10,"USC Upstate",72,"Longwood",85,13
2021-11-09,"West Florida",47,"Louisiana",81,34
2021-11-17,"Xavier LA",72,"Louisiana",84,12
2021-11-27,"Jackson St.",75,"Louisiana",70,-5
2021-12-03,"New Orleans",67,"Louisiana",80,13
2021-12-08,"McNeese St.",68,"Louisiana",83,15
2022-01-06,"Arkansas St.",77,"Louisiana",83,6
2022-01-20,"South Alabama",77,"Louisiana",70,-7
2022-01-22,"Troy",59,"Louisiana",69,10
2022-01-27,"Georgia St.",68,"Louisiana",64,-4
2022-01-29,"Georgia Southern",66,"Louisiana",65,-1
2022-02-10,"Texas St.",82,"Louisiana",73,-9
2022-02-12,"UT Arlington",80,"Louisiana",77,-3
2021-11-16,"Champion Christian",59,"Louisiana Monroe",114,55
2021-11-22,"Northwestern St.",66,"Louisiana Monroe",96,30
2021-12-01,"Centenary",67,"Louisiana Monroe",104,37
2021-12-04,"Northwestern St.",71,"Louisiana Monroe",84,13
2021-12-08,"Louisiana College",68,"Louisiana Monroe",89,21
2021-12-18,"Southern Miss",65,"Louisiana Monroe",74,9
2022-01-06,"Little Rock",72,"Louisiana Monroe",80,8
2022-01-08,"Arkansas St.",90,"Louisiana Monroe",83,-7
2022-01-20,"Troy",73,"Louisiana Monroe",65,-8
2022-01-22,"South Alabama",68,"Louisiana Monroe",56,-12
2022-01-27,"Georgia Southern",50,"Louisiana Monroe",45,-5
2022-01-29,"Georgia St.",73,"Louisiana Monroe",62,-11
2022-02-10,"UT Arlington",71,"Louisiana Monroe",74,3
2022-02-12,"Texas St.",63,"Louisiana Monroe",54,-9
2021-11-12,"Jackson St.",68,"Louisiana Tech",70,2
2021-11-15,"Jarvis Christian",61,"Louisiana Tech",91,30
2021-11-24,"Louisiana Monroe",74,"Louisiana Tech",96,22
2021-12-01,"Texas Southern",60,"Louisiana Tech",87,27
2021-12-11,"Louisiana",69,"Louisiana Tech",78,9
2021-12-14,"LSU Shreveport",70,"Louisiana Tech",84,14
2021-12-22,"Crowley's Ridge",56,"Louisiana Tech",99,43
2021-12-30,"Marshall",56,"Louisiana Tech",79,23
2022-01-01,"Western Kentucky",73,"Louisiana Tech",74,1
2022-01-13,"Southern Miss",57,"Louisiana Tech",80,23
2022-01-22,"UAB",83,"Louisiana Tech",76,-7
2022-01-27,"Rice",63,"Louisiana Tech",80,17
2022-01-29,"North Texas",63,"Louisiana Tech",62,-1
2021-11-09,"Southern",60,"Louisville",72,12
2021-11-12,"Furman",80,"Louisville",72,-8
2021-11-15,"Navy",60,"Louisville",77,17
2021-11-20,"Detroit Mercy",67,"Louisville",73,6
2021-11-27,"Maryland",55,"Louisville",63,8
2021-12-10,"DePaul",62,"Louisville",55,-7
2021-12-14,"Southeastern Louisiana",60,"Louisville",86,26
2021-12-29,"Wake Forest",69,"Louisville",73,4
2022-01-05,"Pittsburgh",72,"Louisville",75,3
2022-01-12,"N.C. State",79,"Louisville",63,-16
2022-01-19,"Boston College",54,"Louisville",67,13
2022-01-22,"Notre Dame",82,"Louisville",70,-12
2022-01-29,"Duke",74,"Louisville",65,-9
2022-02-01,"North Carolina",90,"Louisville",83,-7
2021-11-09,"Coppin St.",45,"Loyola Chicago",103,58
2021-11-13,"Florida Gulf Coast",77,"Loyola Chicago",89,12
2021-11-16,"Chicago St.",56,"Loyola Chicago",92,36
2021-11-20,"Illinois Chicago",63,"Loyola Chicago",80,17
2021-11-24,"Michigan St.",63,"Loyola Chicago",61,-2
2021-12-01,"Indiana St.",76,"Loyola Chicago",88,12
2021-12-07,"Roosevelt",49,"Loyola Chicago",88,39
2022-01-08,"Bradley",71,"Loyola Chicago",78,7
2022-01-11,"Valparaiso",74,"Loyola Chicago",81,7
2022-01-22,"Missouri St.",79,"Loyola Chicago",69,-10
2022-01-25,"Southern Illinois",47,"Loyola Chicago",59,12
2022-02-02,"Illinois St.",64,"Loyola Chicago",78,14
2021-11-09,"Chattanooga",75,"Loyola Marymount",64,-11
2021-11-13,"Arizona Christian",67,"Loyola Marymount",74,7
2021-11-17,"Little Rock",63,"Loyola Marymount",82,19
2021-11-21,"Florida St.",73,"Loyola Marymount",45,-28
2021-11-27,"Prairie View A&M",80,"Loyola Marymount",83,3
2021-11-29,"Grand Canyon",78,"Loyola Marymount",72,-6
2021-12-11,"New Mexico St.",63,"Loyola Marymount",58,-5
2022-01-17,"Portland",58,"Loyola Marymount",70,12
2022-01-20,"Pepperdine",80,"Loyola Marymount",85,5
2022-01-22,"Saint Mary's",83,"Loyola Marymount",51,-32
2022-01-29,"San Diego",69,"Loyola Marymount",65,-4
2022-02-10,"BYU",83,"Loyola Marymount",82,-1
2021-11-12,"South Carolina St.",65,"Loyola MD",75,10
2021-11-14,"Lipscomb",70,"Loyola MD",65,-5
2021-11-24,"Elizabethtown",42,"Loyola MD",69,27
2021-12-01,"Chicago St.",64,"Loyola MD",78,14
2021-12-04,"Mount St. Mary's",55,"Loyola MD",61,6
2021-12-12,"Hampton",54,"Loyola MD",67,13
2022-01-04,"Holy Cross",70,"Loyola MD",79,9
2022-01-10,"Bucknell",67,"Loyola MD",71,4
2022-01-13,"Lafayette",60,"Loyola MD",74,14
2022-01-19,"Boston University",67,"Loyola MD",50,-17
2022-01-22,"American",73,"Loyola MD",78,5
2022-02-02,"Army",57,"Loyola MD",61,4
2022-02-05,"Navy",56,"Loyola MD",55,-1
2022-02-12,"Colgate",64,"Loyola MD",56,-8
2021-11-09,"Louisiana Monroe",39,"LSU",101,62
2021-11-12,"Texas St.",59,"LSU",84,25
2021-11-15,"Liberty",58,"LSU",74,16
2021-11-18,"McNeese St.",46,"LSU",85,39
2021-11-22,"Belmont",53,"LSU",83,30
2021-12-01,"Ohio",51,"LSU",66,15
2021-12-14,"Northwestern St.",49,"LSU",89,40
2021-12-18,"Louisiana Tech",57,"LSU",66,9
2021-12-22,"Lipscomb",60,"LSU",95,35
2022-01-04,"Kentucky",60,"LSU",65,5
2022-01-08,"Tennessee",67,"LSU",79,12
2022-01-15,"Arkansas",65,"LSU",58,-7
2022-01-26,"Texas A&M",64,"LSU",70,6
2022-02-01,"Mississippi",76,"LSU",72,-4
2022-02-12,"Mississippi St.",65,"LSU",69,4
2021-11-12,"Maine Farmington",52,"Maine",71,19
2021-11-19,"Maine Fort Kent",43,"Maine",75,32
2021-11-23,"Central Connecticut",64,"Maine",56,-8
2021-12-18,"New England",50,"Maine",86,36
2021-12-21,"Merrimack",49,"Maine",47,-2
2022-01-16,"Binghamton",73,"Maine",65,-8
2022-01-22,"UMBC",88,"Maine",46,-42
2022-01-24,"New Hampshire",64,"Maine",71,7
2022-01-31,"Hartford",78,"Maine",66,-12
2022-02-02,"UMass Lowell",62,"Maine",50,-12
2021-11-09,"Manhattanville",42,"Manhattan",99,57
2021-11-12,"Fordham",60,"Manhattan",66,6
2021-11-19,"North Alabama",51,"Manhattan",55,4
2021-11-20,"Liberty",60,"Manhattan",76,16
2021-11-30,"Fairleigh Dickinson",73,"Manhattan",78,5
2021-12-05,"Quinnipiac",90,"Manhattan",73,-17
2022-01-16,"Canisius",75,"Manhattan",80,5
2022-01-18,"Niagara",72,"Manhattan",63,-9
2022-01-21,"Siena",68,"Manhattan",75,7
2022-01-30,"Marist",66,"Manhattan",72,6
2022-02-11,"Monmouth",75,"Manhattan",65,-10
2021-11-20,"VMI",74,"Marist",78,4
2021-12-01,"Iona",78,"Marist",71,-7
2021-12-12,"Navy",67,"Marist",61,-6
2021-12-22,"Bethune Cookman",45,"Marist",68,23
2022-01-09,"Rider",79,"Marist",75,-4
2022-01-14,"Siena",67,"Marist",60,-7
2022-01-16,"Monmouth",48,"Marist",84,36
2022-01-23,"Fairfield",69,"Marist",66,-3
2022-01-26,"Saint Peter's",69,"Marist",62,-7
2022-02-12,"Canisius",70,"Marist",71,1
2021-11-09,"SIU Edwardsville",77,"Marquette",88,11
2021-11-12,"New Hampshire",70,"Marquette",75,5
2021-11-15,"Illinois",66,"Marquette",67,1
2021-11-21,"St. Bonaventure",70,"Marquette",54,-16
2021-11-27,"Northern Illinois",66,"Marquette",80,14
2021-11-30,"Jackson St.",54,"Marquette",83,29
2021-12-11,"UCLA",67,"Marquette",56,-11
2021-12-21,"Connecticut",78,"Marquette",70,-8
2022-01-01,"Creighton",75,"Marquette",69,-6
2022-01-04,"Providence",56,"Marquette",88,32
2022-01-11,"DePaul",76,"Marquette",87,11
2022-01-15,"Seton Hall",72,"Marquette",73,1
2022-01-23,"Xavier",64,"Marquette",75,11
2022-02-02,"Villanova",73,"Marquette",83,10
2021-11-12,"Wright St.",88,"Marshall",96,8
2021-11-15,"Milligan",58,"Marshall",80,22
2021-11-18,"Campbell",67,"Marshall",65,-2
2021-11-21,"Jackson St.",66,"Marshall",80,14
2021-11-23,"Louisiana",79,"Marshall",93,14
2021-12-04,"Duquesne",71,"Marshall",72,1
2021-12-08,"Bluefield",57,"Marshall",100,43
2021-12-18,"Northern Iowa",75,"Marshall",60,-15
2022-01-08,"Florida Atlantic",90,"Marshall",77,-13
2022-01-13,"North Texas",69,"Marshall",65,-4
2022-01-15,"Rice",87,"Marshall",77,-10
2022-01-27,"Middle Tennessee",81,"Marshall",79,-2
2022-01-29,"UAB",81,"Marshall",84,3
2022-02-10,"FIU",72,"Marshall",71,-1
2021-11-09,"Quinnipiac",69,"Maryland",83,14
2021-11-11,"George Washington",64,"Maryland",71,7
2021-11-13,"Vermont",57,"Maryland",68,11
2021-11-17,"George Mason",71,"Maryland",66,-5
2021-11-19,"Hofstra",67,"Maryland",69,2
2021-12-01,"Virginia Tech",62,"Maryland",58,-4
2021-12-05,"Northwestern",67,"Maryland",61,-6
2021-12-12,"Florida",68,"Maryland",70,2
2021-12-28,"Lehigh",55,"Maryland",76,21
2021-12-30,"Brown",67,"Maryland",81,14
2022-01-09,"Wisconsin",70,"Maryland",69,-1
2022-01-15,"Rutgers",70,"Maryland",59,-11
2022-01-21,"Illinois",65,"Maryland",81,16
2022-01-29,"Indiana",68,"Maryland",55,-13
2022-02-01,"Michigan St.",65,"Maryland",63,-2
2022-02-10,"Iowa",110,"Maryland",87,-23
2021-11-13,"Bryn Athyn",42,"Maryland Eastern Shore",91,49
2021-12-08,"Clarks Summit",58,"Maryland Eastern Shore",102,44
2021-12-11,"St. Mary's MD",43,"Maryland Eastern Shore",79,36
2022-01-17,"Norfolk St.",72,"Maryland Eastern Shore",58,-14
2022-01-22,"South Carolina St.",69,"Maryland Eastern Shore",60,-9
2022-01-24,"North Carolina Central",75,"Maryland Eastern Shore",63,-12
2022-01-31,"Morgan St.",72,"Maryland Eastern Shore",79,7
2021-11-09,"UMBC",60,"Massachusetts",77,17
2021-11-15,"Penn St.",56,"Massachusetts",81,25
2021-11-19,"UNC Greensboro",90,"Massachusetts",93,3
2021-11-24,"UMass Lowell",81,"Massachusetts",92,11
2021-11-27,"Rutgers",83,"Massachusetts",85,2
2021-12-04,"Harvard",77,"Massachusetts",87,10
2021-12-19,"Fairfield",73,"Massachusetts",77,4
2022-01-08,"Duquesne",78,"Massachusetts",74,-4
2022-01-15,"Rhode Island",81,"Massachusetts",68,-13
2022-01-20,"Saint Louis",85,"Massachusetts",91,6
2022-01-30,"George Mason",72,"Massachusetts",62,-10
2022-02-09,"George Washington",77,"Massachusetts",68,-9
2022-02-12,"Saint Joseph's",67,"Massachusetts",69,2
2021-11-15,"Champion Christian",66,"McNeese St.",116,50
2021-11-22,"Carver",54,"McNeese St.",98,44
2021-12-30,"Ecclesia",66,"McNeese St.",115,49
2022-01-06,"New Orleans",82,"McNeese St.",92,10
2022-01-07,"Southeastern Louisiana",83,"McNeese St.",78,-5
2022-01-12,"Arlington Baptist",44,"McNeese St.",120,76
2022-01-15,"Houston Baptist",75,"McNeese St.",78,3
2022-01-27,"Nicholls St.",81,"McNeese St.",71,-10
2022-01-30,"New Orleans",84,"McNeese St.",78,-6
2022-02-03,"Southeastern Louisiana",83,"McNeese St.",78,-5
2022-02-05,"Northwestern St.",84,"McNeese St.",93,9
2021-11-09,"Tennessee Tech",65,"Memphis",89,24
2021-11-13,"North Carolina Central",51,"Memphis",90,39
2021-11-16,"Saint Louis",74,"Memphis",90,16
2021-11-19,"Western Kentucky",62,"Memphis",74,12
2021-11-26,"Iowa St.",78,"Memphis",59,-19
2021-12-10,"Murray St.",74,"Memphis",72,-2
2021-12-14,"Alabama",78,"Memphis",92,14
2022-01-04,"Tulsa",64,"Memphis",67,3
2022-01-09,"Cincinnati",80,"Memphis",87,7
2022-01-20,"SMU",70,"Memphis",62,-8
2022-01-27,"East Carolina",54,"Memphis",71,17
2022-02-05,"UCF",60,"Memphis",88,28
2022-02-09,"Tulane",69,"Memphis",80,11
2021-11-16,"Life",50,"Mercer",78,28
2021-11-23,"Bucknell",68,"Mercer",78,10
2021-11-24,"Middle Tennessee",82,"Mercer",58,-24
2021-11-27,"Milligan",49,"Mercer",88,39
2021-12-04,"Georgia St.",77,"Mercer",83,6
2021-12-11,"Georgia Southern",68,"Mercer",77,9
2021-12-22,"Troy",69,"Mercer",65,-4
2022-01-05,"Samford",80,"Mercer",83,3
2022-01-13,"VMI",91,"Mercer",97,6
2022-01-15,"UNC Greensboro",49,"Mercer",58,9
2022-01-22,"Western Carolina",64,"Mercer",72,8
2022-01-29,"Furman",80,"Mercer",50,-30
2022-01-31,"Wofford",62,"Mercer",67,5
2022-02-07,"Chattanooga",74,"Mercer",72,-2
2021-11-09,"Emerson",48,"Merrimack",77,29
2021-11-19,"Lehigh",45,"Merrimack",55,10
2021-11-23,"Hartford",60,"Merrimack",75,15
2021-12-04,"UMass Lowell",61,"Merrimack",57,-4
2021-12-07,"Brown",76,"Merrimack",56,-20
2021-12-29,"St. Francis NY",64,"Merrimack",74,10
2021-12-31,"LIU",77,"Merrimack",82,5
2022-01-15,"St. Francis PA",62,"Merrimack",46,-16
2022-01-17,"Mount St. Mary's",57,"Merrimack",50,-7
2022-01-21,"Bryant",79,"Merrimack",63,-16
2022-01-23,"Wagner",71,"Merrimack",57,-14
2022-02-10,"Central Connecticut",60,"Merrimack",57,-3
2021-11-09,"Canisius",67,"Miami FL",77,10
2021-11-13,"UCF",95,"Miami FL",89,-6
2021-11-21,"Florida A&M",59,"Miami FL",86,27
2021-11-25,"Dayton",76,"Miami FL",60,-16
2021-12-04,"Clemson",75,"Miami FL",80,5
2021-12-08,"Lipscomb",59,"Miami FL",76,17
2021-12-20,"Stetson",72,"Miami FL",82,10
2021-12-29,"N.C. State",83,"Miami FL",91,8
2022-01-01,"Wake Forest",84,"Miami FL",92,8
2022-01-05,"Syracuse",87,"Miami FL",88,1
2022-01-18,"North Carolina",57,"Miami FL",85,28
2022-01-22,"Florida St.",61,"Miami FL",60,-1
2022-02-02,"Notre Dame",68,"Miami FL",64,-4
2022-02-09,"Georgia Tech",70,"Miami FL",79,9
2021-11-13,"Lamar",75,"Miami OH",104,29
2021-11-17,"Stetson",65,"Miami OH",80,15
2021-11-20,"Heidelberg",45,"Miami OH",90,45
2021-11-23,"Defiance",47,"Miami OH",99,52
2021-12-01,"Cincinnati",59,"Miami OH",58,-1
2021-12-18,"Bellarmine",77,"Miami OH",68,-9
2021-12-21,"Spalding",56,"Miami OH",80,24
2022-01-11,"Toledo",75,"Miami OH",72,-3
2022-01-18,"Ohio",86,"Miami OH",63,-23
2022-01-22,"Northern Illinois",82,"Miami OH",85,3
2022-02-01,"Kent St.",78,"Miami OH",65,-13
2022-02-06,"Akron",71,"Miami OH",59,-12
2022-02-08,"Western Michigan",57,"Miami OH",62,5
2022-02-12,"Bowling Green",78,"Miami OH",94,16
2021-11-10,"Buffalo",76,"Michigan",88,12
2021-11-13,"Prairie View A&M",49,"Michigan",77,28
2021-11-16,"Seton Hall",67,"Michigan",65,-2
2021-11-21,"Arizona",80,"Michigan",62,-18
2021-11-24,"Tarleton St.",54,"Michigan",65,11
2021-12-04,"San Diego St.",58,"Michigan",72,14
2021-12-11,"Minnesota",75,"Michigan",65,-10
2021-12-18,"Southern Utah",50,"Michigan",87,37
2022-01-18,"Maryland",64,"Michigan",83,19
2022-01-26,"Northwestern",70,"Michigan",72,2
2022-02-01,"Nebraska",79,"Michigan",85,6
2022-02-10,"Purdue",58,"Michigan",82,24
2022-02-12,"Ohio St.",68,"Michigan",57,-11
2021-11-09,"Kansas",87,"Michigan St.",74,-13
2021-11-12,"Western Michigan",46,"Michigan St.",90,44
2021-11-20,"Eastern Michigan",59,"Michigan St.",83,24
2021-12-01,"Louisville",64,"Michigan St.",73,9
2021-12-04,"Toledo",68,"Michigan St.",81,13
2021-12-11,"Penn St.",64,"Michigan St.",80,16
2021-12-29,"High Point",68,"Michigan St.",81,13
2022-01-05,"Nebraska",67,"Michigan St.",79,12
2022-01-12,"Minnesota",69,"Michigan St.",71,2
2022-01-15,"Northwestern",64,"Michigan St.",62,-2
2022-01-29,"Michigan",67,"Michigan St.",83,16
2022-02-08,"Wisconsin",70,"Michigan St.",62,-8
2022-02-12,"Indiana",61,"Michigan St.",76,15
2021-11-09,"Brescia",59,"Middle Tennessee",98,39
2021-11-12,"Bethune Cookman",51,"Middle Tennessee",71,20
2021-11-16,"Winthrop",65,"Middle Tennessee",76,11
2021-11-27,"Bryan",48,"Middle Tennessee",96,48
2021-12-01,"Tennessee Martin",61,"Middle Tennessee",73,12
2021-12-19,"Coastal Carolina",80,"Middle Tennessee",84,4
2022-01-13,"Florida Atlantic",57,"Middle Tennessee",70,13
2022-01-15,"FIU",39,"Middle Tennessee",50,11
2022-01-22,"Southern Miss",60,"Middle Tennessee",74,14
2022-02-07,"UTSA",75,"Middle Tennessee",84,9
2022-02-10,"Old Dominion",48,"Middle Tennessee",63,15
2021-11-13,"Eastern Kentucky",77,"Milwaukee",71,-6
2021-11-24,"Yale",69,"Milwaukee",56,-13
2021-11-28,"Alcorn St.",61,"Milwaukee",57,-4
2021-12-02,"Youngstown St.",70,"Milwaukee",68,-2
2021-12-04,"Robert Morris",69,"Milwaukee",77,8
2021-12-13,"Rhode Island",82,"Milwaukee",58,-24
2021-12-23,"St. Xavier IL",52,"Milwaukee",74,22
2022-01-13,"Illinois Chicago",81,"Milwaukee",77,-4
2022-01-15,"IUPUI",54,"Milwaukee",89,35
2022-01-20,"Oakland",78,"Milwaukee",88,10
2022-01-22,"Detroit Mercy",71,"Milwaukee",58,-13
2022-02-09,"Northern Kentucky",75,"Milwaukee",39,-36
2022-02-11,"Wright St.",57,"Milwaukee",60,3
2021-11-09,"UMKC",56,"Minnesota",71,15
2021-11-12,"Western Kentucky",69,"Minnesota",73,4
2021-11-19,"Purdue Fort Wayne",49,"Minnesota",78,29
2021-11-24,"Jacksonville",44,"Minnesota",55,11
2021-12-08,"Michigan St.",75,"Minnesota",67,-8
2021-12-14,"Texas A&M Corpus Chris",71,"Minnesota",79,8
2021-12-22,"Green Bay",56,"Minnesota",72,16
2022-01-04,"Illinois",76,"Minnesota",53,-23
2022-01-16,"Iowa",81,"Minnesota",71,-10
2022-01-22,"Rutgers",65,"Minnesota",68,3
2022-01-27,"Ohio St.",75,"Minnesota",64,-11
2022-02-02,"Purdue",88,"Minnesota",73,-15
2022-02-12,"Penn St.",70,"Minnesota",76,6
2021-11-09,"New Orleans",61,"Mississippi",82,21
2021-11-12,"Charleston Southern",68,"Mississippi",93,25
2021-11-18,"Marquette",78,"Mississippi",72,-6
2021-11-21,"Boise St.",60,"Mississippi",50,-10
2021-11-26,"Mississippi Valley St.",58,"Mississippi",73,15
2021-11-30,"Rider",51,"Mississippi",75,24
2021-12-04,"Memphis",63,"Mississippi",67,4
2021-12-11,"Western Kentucky",71,"Mississippi",48,-23
2021-12-15,"Middle Tennessee",52,"Mississippi",62,10
2021-12-18,"Dayton",68,"Mississippi",76,8
2021-12-21,"Samford",75,"Mississippi",73,-2
2022-01-08,"Mississippi St.",72,"Mississippi",82,10
2022-01-15,"Auburn",80,"Mississippi",71,-9
2022-01-18,"Missouri",78,"Mississippi",53,-25
2022-01-24,"Florida",54,"Mississippi",70,16
2022-01-26,"Arkansas",64,"Mississippi",55,-9
2022-01-29,"Kansas St.",56,"Mississippi",67,11
2022-02-09,"Alabama",97,"Mississippi",83,-14
2021-11-10,"North Alabama",49,"Mississippi St.",75,26
2021-11-13,"Montana",49,"Mississippi St.",86,37
2021-11-17,"Detroit Mercy",64,"Mississippi St.",77,13
2021-11-21,"Morehead St.",46,"Mississippi St.",66,20
2021-11-25,"Louisville",72,"Mississippi St.",58,-14
2021-11-27,"Richmond",71,"Mississippi St.",82,11
2021-12-02,"Lamar",60,"Mississippi St.",75,15
2021-12-05,"Minnesota",81,"Mississippi St.",76,-5
2021-12-11,"Colorado St.",66,"Mississippi St.",63,-3
2021-12-14,"Georgia St.",50,"Mississippi St.",79,29
2021-12-17,"Furman",66,"Mississippi St.",69,3
2021-12-21,"Winthrop",63,"Mississippi St.",84,21
2021-12-29,"Arkansas",68,"Mississippi St.",81,13
2022-01-12,"Georgia",72,"Mississippi St.",88,16
2022-01-15,"Alabama",76,"Mississippi St.",78,2
2022-01-22,"Mississippi",60,"Mississippi St.",78,18
2022-02-01,"South Carolina",64,"Mississippi St.",78,14
2022-02-09,"Tennessee",72,"Mississippi St.",63,-9
2021-12-09,"Nicholls St.",95,"Mississippi Valley St.",80,-15
2021-12-11,"Arkansas St.",82,"Mississippi Valley St.",77,-5
2022-01-03,"Alabama St.",84,"Mississippi Valley St.",75,-9
2022-01-05,"Alabama A&M",72,"Mississippi Valley St.",67,-5
2022-01-15,"Bethune Cookman",62,"Mississippi Valley St.",60,-2
2022-01-17,"Florida A&M",78,"Mississippi Valley St.",70,-8
2022-01-29,"Arkansas Pine Bluff",74,"Mississippi Valley St.",68,-6
2022-02-05,"Jackson St.",69,"Mississippi Valley St.",65,-4
2022-02-07,"Alcorn St.",79,"Mississippi Valley St.",71,-8
2021-11-09,"Central Michigan",68,"Missouri",78,10
2021-11-15,"UMKC",80,"Missouri",66,-14
2021-11-18,"Northern Illinois",37,"Missouri",54,17
2021-11-22,"Florida St.",81,"Missouri",58,-23
2021-11-26,"Wichita St.",61,"Missouri",55,-6
2021-11-29,"Paul Quinn",59,"Missouri",91,32
2021-12-07,"Eastern Illinois",44,"Missouri",72,28
2021-12-18,"Utah",75,"Missouri",83,8
2021-12-22,"Illinois",88,"Missouri",63,-25
2022-01-08,"Alabama",86,"Missouri",92,6
2022-01-15,"Texas A&M",67,"Missouri",64,-3
2022-01-25,"Auburn",55,"Missouri",54,-1
2022-02-02,"Florida",66,"Missouri",65,-1
2022-02-12,"Mississippi",68,"Missouri",74,6
2021-11-09,"Southeast Missouri St.",99,"Missouri St.",94,-5
2021-11-13,"Alabama St.",60,"Missouri St.",78,18
2021-11-23,"East Tennessee St.",77,"Missouri St.",76,-1
2021-11-24,"George Washington",54,"Missouri St.",72,18
2021-12-04,"BYU",74,"Missouri St.",68,-6
2021-12-11,"Oral Roberts",60,"Missouri St.",69,9
2021-12-15,"South Dakota St.",63,"Missouri St.",75,12
2021-12-18,"Central Arkansas",70,"Missouri St.",106,36
2021-12-30,"Evangel",56,"Missouri St.",103,47
2022-01-02,"Drake",56,"Missouri St.",61,5
2022-01-08,"Northern Iowa",85,"Missouri St.",84,-1
2022-01-12,"Southern Illinois",76,"Missouri St.",81,5
2022-01-19,"Illinois St.",63,"Missouri St.",88,25
2022-01-29,"Evansville",58,"Missouri St.",72,14
2022-02-06,"Loyola Chicago",71,"Missouri St.",62,-9
2022-02-12,"Valparaiso",66,"Missouri St.",84,18
2021-11-16,"Lehigh",75,"Monmouth",85,10
2021-11-24,"Princeton",64,"Monmouth",76,12
2021-12-19,"Colgate",66,"Monmouth",77,11
2021-12-22,"Hofstra",77,"Monmouth",71,-6
2022-01-18,"Iona",86,"Monmouth",85,-1
2022-01-23,"Manhattan",62,"Monmouth",78,16
2022-01-28,"Canisius",67,"Monmouth",72,5
2022-01-30,"Niagara",70,"Monmouth",69,-1
2022-02-04,"Fairfield",56,"Monmouth",59,3
2022-02-08,"Marist",83,"Monmouth",58,-25
2021-11-09,"Dickinson St.",27,"Montana",74,47
2021-11-20,"Nebraska Omaha",47,"Montana",68,21
2021-11-24,"UC San Diego",61,"Montana",71,10
2021-11-26,"Southern Miss",62,"Montana",74,12
2021-12-08,"Air Force",48,"Montana",66,18
2021-12-10,"Yellowstone Christian",43,"Montana",104,61
2021-12-13,"American Indian",49,"Montana",118,69
2021-12-30,"Idaho St.",54,"Montana",78,24
2022-01-01,"Weber St.",72,"Montana",74,2
2022-01-27,"Idaho",62,"Montana",81,19
2022-01-29,"Eastern Washington",59,"Montana",61,2
2022-02-07,"Southern Utah",67,"Montana",78,11
2022-02-10,"Northern Arizona",72,"Montana",67,-5
2022-02-12,"Portland St.",76,"Montana",85,9
2021-11-14,"Rocky Mountain",52,"Montana St.",81,29
2021-11-26,"Portland",66,"Montana St.",69,3
2021-11-28,"Southeast Missouri St.",68,"Montana St.",75,7
2021-12-07,"North Dakota St.",49,"Montana St.",68,19
2021-12-19,"Portland",59,"Montana St.",61,2
2021-12-22,"American Indian",73,"Montana St.",124,51
2021-12-30,"Weber St.",85,"Montana St.",75,-10
2022-01-01,"Idaho St.",40,"Montana St.",60,20
2022-01-09,"Montana",59,"Montana St.",66,7
2022-01-27,"Eastern Washington",65,"Montana St.",69,4
2022-01-29,"Idaho",64,"Montana St.",70,6
2022-02-10,"Portland St.",74,"Montana St.",77,3
2022-02-12,"Northern Arizona",70,"Montana St.",72,2
2021-11-15,"Kentucky Christian",57,"Morehead St.",82,25
2021-11-18,"Transylvania",59,"Morehead St.",84,25
2021-11-27,"UMKC",62,"Morehead St.",70,8
2021-12-01,"Georgia Southern",51,"Morehead St.",59,8
2021-12-06,"Presbyterian",66,"Morehead St.",71,5
2021-12-18,"Alice Lloyd",47,"Morehead St.",87,40
2021-12-29,"Eastern Illinois",50,"Morehead St.",63,13
2022-01-12,"Tennessee Martin",62,"Morehead St.",76,14
2022-01-20,"Belmont",74,"Morehead St.",83,9
2022-01-22,"SIU Edwardsville",74,"Morehead St.",77,3
2022-01-24,"Tennessee St.",54,"Morehead St.",67,13
2022-02-03,"Tennessee Tech",68,"Morehead St.",75,7
2022-02-05,"Austin Peay",52,"Morehead St.",77,25
2022-02-12,"Murray St.",57,"Morehead St.",53,-4
2021-11-09,"St. Mary's MD",55,"Morgan St.",118,63
2021-11-11,"Penn State Allegheny",71,"Morgan St.",126,55
2021-12-06,"Millersville",71,"Morgan St.",77,6
2022-01-05,"Goucher",41,"Morgan St.",100,59
2022-01-15,"Coppin St.",79,"Morgan St.",76,-3
2022-01-22,"Howard",91,"Morgan St.",82,-9
2022-01-30,"Delaware St.",70,"Morgan St.",82,12
2022-02-12,"North Carolina Central",74,"Morgan St.",64,-10
2021-11-11,"Washington College",62,"Mount St. Mary's",117,55
2021-11-27,"Navy",67,"Mount St. Mary's",40,-27
2021-11-30,"Howard",70,"Mount St. Mary's",72,2
2021-12-11,"American",72,"Mount St. Mary's",66,-6
2021-12-18,"Morgan St.",60,"Mount St. Mary's",74,14
2022-01-21,"Sacred Heart",59,"Mount St. Mary's",98,39
2022-01-23,"Central Connecticut",50,"Mount St. Mary's",65,15
2022-01-29,"St. Francis PA",54,"Mount St. Mary's",71,17
2022-02-03,"Merrimack",53,"Mount St. Mary's",69,16
2022-02-05,"Bryant",62,"Mount St. Mary's",61,-1
2021-11-09,"Cumberland",77,"Murray St.",109,32
2021-11-13,"Bellarmine",59,"Murray St.",78,19
2021-11-22,"East Tennessee St.",66,"Murray St.",58,-8
2021-11-24,"James Madison",62,"Murray St.",74,12
2021-11-29,"Campbellsville",61,"Murray St.",98,37
2021-12-04,"Middle Tennessee",87,"Murray St.",93,6
2021-12-15,"Tennessee Wesleyan",48,"Murray St.",118,70
2021-12-18,"Chattanooga",76,"Murray St.",87,11
2021-12-30,"Southeast Missouri St.",81,"Murray St.",106,25
2022-01-13,"Tennessee St.",44,"Murray St.",67,23
2022-01-20,"Eastern Illinois",51,"Murray St.",91,40
2022-01-22,"Tennessee Martin",66,"Murray St.",74,8
2022-01-24,"Tennessee Tech",53,"Murray St.",79,26
2022-01-29,"Morehead St.",66,"Murray St.",77,11
2022-02-05,"SIU Edwardsville",59,"Murray St.",79,20
2021-11-09,"Bucknell",70,"N.C. State",88,18
2021-11-13,"Colgate",74,"N.C. State",77,3
2021-11-21,"Texas Southern",57,"N.C. State",65,8
2021-11-27,"Louisiana Tech",81,"N.C. State",90,9
2021-12-01,"Nebraska",100,"N.C. State",104,4
2021-12-04,"Louisville",73,"N.C. State",68,-5
2021-12-09,"Bethune Cookman",48,"N.C. State",65,17
2021-12-12,"Purdue",82,"N.C. State",72,-10
2021-12-17,"Richmond",83,"N.C. State",74,-9
2021-12-21,"Wright St.",84,"N.C. State",70,-14
2022-01-01,"Florida St.",83,"N.C. State",81,-2
2022-01-08,"Clemson",70,"N.C. State",65,-5
2022-01-19,"Virginia Tech",62,"N.C. State",59,-3
2022-01-22,"Virginia",63,"N.C. State",77,14
2022-02-02,"Syracuse",89,"N.C. State",82,-7
2022-02-05,"Notre Dame",69,"N.C. State",57,-12
2022-02-09,"Wake Forest",69,"N.C. State",51,-18
2021-11-12,"Virginia Tech",77,"Navy",57,-20
2021-11-24,"Washington College",40,"Navy",89,49
2021-12-01,"William & Mary",56,"Navy",75,19
2021-12-22,"Towson",69,"Navy",52,-17
2022-01-04,"Boston University",71,"Navy",83,12
2022-01-07,"Bucknell",55,"Navy",73,18
2022-01-13,"Colgate",69,"Navy",50,-19
2022-01-19,"Lehigh",69,"Navy",61,-8
2022-01-22,"Army",74,"Navy",73,-1
2022-01-29,"American",45,"Navy",47,2
2022-02-07,"Lafayette",44,"Navy",68,24
2021-11-09,"Western Illinois",75,"Nebraska",74,-1
2021-11-12,"Sam Houston St.",65,"Nebraska",74,9
2021-11-16,"Creighton",77,"Nebraska",69,-8
2021-11-19,"Idaho St.",60,"Nebraska",78,18
2021-11-21,"Southern",59,"Nebraska",82,23
2021-11-23,"Tennessee St.",73,"Nebraska",79,6
2021-11-27,"South Dakota",70,"Nebraska",83,13
2021-12-07,"Michigan",102,"Nebraska",67,-35
2021-12-19,"Kansas St.",67,"Nebraska",58,-9
2021-12-22,"Kennesaw St.",74,"Nebraska",88,14
2022-01-02,"Ohio St.",87,"Nebraska",79,-8
2022-01-11,"Illinois",81,"Nebraska",71,-10
2022-01-17,"Indiana",78,"Nebraska",71,-7
2022-01-27,"Wisconsin",73,"Nebraska",65,-8
2022-01-29,"Rutgers",63,"Nebraska",61,-2
2022-02-05,"Northwestern",87,"Nebraska",63,-24
2022-02-09,"Minnesota",65,"Nebraska",78,13
2021-11-09,"Hastings",57,"Nebraska Omaha",67,10
2021-11-30,"SIU Edwardsville",75,"Nebraska Omaha",65,-10
2021-12-04,"Eastern Washington",92,"Nebraska Omaha",81,-11
2021-12-08,"Drake",78,"Nebraska Omaha",70,-8
2021-12-11,"Texas A&M Corpus Chris",87,"Nebraska Omaha",73,-14
2021-12-20,"St. Thomas",80,"Nebraska Omaha",73,-7
2021-12-22,"Western Illinois",78,"Nebraska Omaha",84,6
2022-01-06,"North Dakota",82,"Nebraska Omaha",98,16
2022-01-08,"North Dakota St.",71,"Nebraska Omaha",67,-4
2022-01-13,"South Dakota St.",95,"Nebraska Omaha",86,-9
2022-01-27,"Oral Roberts",100,"Nebraska Omaha",88,-12
2022-01-29,"UMKC",68,"Nebraska Omaha",69,1
2022-02-10,"South Dakota",91,"Nebraska Omaha",69,-22
2021-11-09,"Eastern Washington",76,"Nevada",91,15
2021-11-12,"San Diego",75,"Nevada",68,-7
2021-11-23,"George Mason",69,"Nevada",88,19
2021-11-24,"Washington",62,"Nevada",81,19
2021-11-30,"Pepperdine",66,"Nevada",79,13
2021-12-15,"Minnesota Duluth",62,"Nevada",98,36
2021-12-18,"Loyola Marymount",63,"Nevada",68,5
2022-01-01,"New Mexico",70,"Nevada",79,9
2022-01-12,"Boise St.",85,"Nevada",70,-15
2022-01-17,"Wyoming",77,"Nevada",67,-10
2022-01-21,"Fresno St.",73,"Nevada",77,4
2022-01-29,"Utah St.",78,"Nevada",49,-29
2022-02-08,"Colorado St.",82,"Nevada",72,-10
2021-11-09,"St. Joseph's ME",53,"New Hampshire",98,45
2021-11-23,"Quinnipiac",69,"New Hampshire",84,15
2021-12-04,"Central Connecticut",45,"New Hampshire",67,22
2021-12-13,"Keene St.",54,"New Hampshire",92,38
2022-01-08,"Albany",62,"New Hampshire",64,2
2022-01-22,"UMass Lowell",61,"New Hampshire",67,6
2022-01-26,"Maine",61,"New Hampshire",73,12
2022-01-28,"Stony Brook",76,"New Hampshire",69,-7
2022-02-02,"Hartford",64,"New Hampshire",70,6
2022-02-09,"NJIT",60,"New Hampshire",55,-5
2021-11-10,"Florida Atlantic",92,"New Mexico",99,7
2021-11-15,"Grambling St.",61,"New Mexico",86,25
2021-11-20,"Montana St.",78,"New Mexico",81,3
2021-11-22,"Western New Mexico",63,"New Mexico",88,25
2021-12-06,"New Mexico St.",78,"New Mexico",76,-2
2021-12-09,"Denver",67,"New Mexico",87,20
2021-12-12,"UTEP",77,"New Mexico",69,-8
2021-12-19,"SMU",90,"New Mexico",72,-18
2021-12-21,"Norfolk St.",54,"New Mexico",68,14
2022-01-08,"Utah St.",90,"New Mexico",87,-3
2022-01-15,"Boise St.",71,"New Mexico",63,-8
2022-01-25,"Fresno St.",65,"New Mexico",60,-5
2022-01-28,"San Jose St.",70,"New Mexico",86,16
2022-02-11,"Northern New Mexico",46,"New Mexico",78,32
2021-11-09,"UC Irvine",51,"New Mexico St.",62,11
2021-11-13,"UTEP",71,"New Mexico St.",77,6
2021-11-18,"Davidson",64,"New Mexico St.",75,11
2021-11-24,"New Mexico Highlands",67,"New Mexico St.",94,27
2021-11-30,"New Mexico",101,"New Mexico St.",94,-7
2021-12-18,"Northern New Mexico",60,"New Mexico St.",93,33
2021-12-20,"Texas Permian Basin",59,"New Mexico St.",84,25
2022-01-01,"Chicago St.",61,"New Mexico St.",78,17
2022-01-13,"Tarleton St.",57,"New Mexico St.",73,16
2022-01-15,"Abilene Christian",63,"New Mexico St.",77,14
2022-01-29,"Grand Canyon",61,"New Mexico St.",71,10
2022-02-03,"Cal Baptist",57,"New Mexico St.",68,11
2022-02-05,"Seattle",64,"New Mexico St.",79,15
2021-11-13,"Spring Hill",41,"New Orleans",79,38
2021-11-19,"Rice",83,"New Orleans",78,-5
2021-11-24,"Central Arkansas",63,"New Orleans",90,27
2021-11-25,"Presbyterian",68,"New Orleans",66,-2
2021-11-26,"VMI",71,"New Orleans",79,8
2021-12-31,"Belhaven",54,"New Orleans",94,40
2022-01-07,"Houston Baptist",65,"New Orleans",81,16
2022-01-11,"Dillard",66,"New Orleans",93,27
2022-01-15,"Nicholls St.",66,"New Orleans",78,12
2022-01-20,"Southeastern Louisiana",72,"New Orleans",78,6
2022-01-22,"Northwestern St.",77,"New Orleans",85,8
2022-02-10,"Texas A&M Corpus Chris",69,"New Orleans",78,9
2022-02-12,"Incarnate Word",57,"New Orleans",84,27
2021-11-19,"SIU Edwardsville",60,"Niagara",70,10
2021-11-20,"St. Thomas",76,"Niagara",67,-9
2021-12-03,"Monmouth",57,"Niagara",49,-8
2021-12-05,"Fairfield",81,"Niagara",71,-10
2021-12-12,"Buffalo St.",52,"Niagara",112,60
2021-12-18,"Albany",58,"Niagara",66,8
2022-01-09,"Quinnipiac",66,"Niagara",76,10
2022-01-13,"Canisius",58,"Niagara",68,10
2022-01-21,"Saint Peter's",74,"Niagara",68,-6
2022-01-23,"Rider",70,"Niagara",67,-3
2022-02-04,"Manhattan",74,"Niagara",80,6
2022-02-06,"Iona",71,"Niagara",80,9
2021-11-12,"Carver",52,"Nicholls St.",120,68
2021-11-13,"Carver",44,"Nicholls St.",101,57
2021-11-22,"Cal Poly",72,"Nicholls St.",75,3
2021-11-27,"Southwestern Christian",58,"Nicholls St.",87,29
2021-12-13,"Blue Mountain",69,"Nicholls St.",87,18
2021-12-18,"Mississippi Valley St.",73,"Nicholls St.",104,31
2022-01-07,"Texas A&M Corpus Chris",75,"Nicholls St.",84,9
2022-01-08,"Southeastern Louisiana",77,"Nicholls St.",72,-5
2022-01-20,"Northwestern St.",58,"Nicholls St.",69,11
2022-01-22,"Southeastern Louisiana",101,"Nicholls St.",93,-8
2022-02-10,"Incarnate Word",58,"Nicholls St.",69,11
2022-02-12,"Texas A&M Corpus Chris",80,"Nicholls St.",83,3
2021-11-11,"Merrimack",61,"NJIT",54,-7
2021-11-24,"Fairleigh Dickinson",54,"NJIT",62,8
2021-11-30,"Sacred Heart",70,"NJIT",75,5
2021-12-02,"Saint Elizabeth",43,"NJIT",76,33
2021-12-10,"Army",66,"NJIT",49,-17
2022-01-02,"Maine",66,"NJIT",69,3
2022-01-12,"UMBC",76,"NJIT",56,-20
2022-01-19,"Vermont",83,"NJIT",57,-26
2022-01-22,"Binghamton",68,"NJIT",57,-11
2022-01-29,"Albany",64,"NJIT",53,-11
2022-02-05,"Stony Brook",62,"NJIT",65,3
2022-02-12,"Hartford",65,"NJIT",49,-16
2021-11-09,"Bridgewater VA",56,"Norfolk St.",79,23
2021-11-11,"Penn St. Wilkes Barre",55,"Norfolk St.",111,56
2021-11-16,"William & Mary",74,"Norfolk St.",91,17
2021-11-23,"Regent",20,"Norfolk St.",95,75
2022-01-12,"Delaware St.",51,"Norfolk St.",80,29
2022-01-22,"Coppin St.",77,"Norfolk St.",84,7
2022-01-24,"Morgan St.",62,"Norfolk St.",82,20
2022-02-12,"Maryland Eastern Shore",63,"Norfolk St.",70,7
2021-11-23,"Oakwood",50,"North Alabama",105,55
2021-12-01,"Mississippi Valley St.",58,"North Alabama",72,14
2021-12-05,"Carver",40,"North Alabama",103,63
2021-12-08,"Alabama A&M",45,"North Alabama",56,11
2021-12-18,"Southeastern Baptist",40,"North Alabama",106,66
2022-01-08,"Jacksonville St.",65,"North Alabama",55,-10
2022-01-11,"Eastern Kentucky",75,"North Alabama",76,1
2022-01-22,"Stetson",67,"North Alabama",65,-2
2022-02-03,"Jacksonville",56,"North Alabama",50,-6
2022-02-05,"North Florida",71,"North Alabama",58,-13
2022-02-12,"Bellarmine",75,"North Alabama",69,-6
2021-11-09,"Loyola MD",67,"North Carolina",83,16
2021-11-12,"Brown",87,"North Carolina",94,7
2021-11-21,"Tennessee",89,"North Carolina",72,-17
2021-11-23,"UNC Asheville",53,"North Carolina",72,19
2021-12-01,"Michigan",51,"North Carolina",72,21
2021-12-11,"Elon",63,"North Carolina",80,17
2021-12-14,"Furman",61,"North Carolina",74,13
2021-12-21,"Appalachian St.",50,"North Carolina",70,20
2022-01-08,"Virginia",58,"North Carolina",74,16
2022-01-15,"Georgia Tech",65,"North Carolina",88,23
2022-01-24,"Virginia Tech",68,"North Carolina",78,10
2022-01-26,"Boston College",47,"North Carolina",58,11
2022-01-29,"N.C. State",80,"North Carolina",100,20
2022-02-05,"Duke",87,"North Carolina",67,-20
2022-02-12,"Florida St.",74,"North Carolina",94,20
2021-11-18,"Greensboro",69,"North Carolina A&T",77,8
2021-11-26,"Samford",77,"North Carolina A&T",75,-2
2021-11-27,"St. Francis NY",67,"North Carolina A&T",73,6
2021-12-03,"Carver",55,"North Carolina A&T",97,42
2021-12-21,"Mid Atlantic Christian",63,"North Carolina A&T",88,25
2022-01-05,"Presbyterian",57,"North Carolina A&T",65,8
2022-01-12,"Hampton",59,"North Carolina A&T",67,8
2022-01-22,"Campbell",73,"North Carolina A&T",72,-1
2022-01-29,"USC Upstate",84,"North Carolina A&T",64,-20
2022-02-09,"Charleston Southern",51,"North Carolina A&T",62,11
2022-02-12,"Longwood",62,"North Carolina A&T",70,8
2021-11-23,"Warren Wilson",32,"North Carolina Central",110,78
2021-11-27,"The Apprentice School",56,"North Carolina Central",96,40
2021-12-09,"Carver",50,"North Carolina Central",102,52
2021-12-15,"Gardner Webb",71,"North Carolina Central",72,1
2022-01-29,"Howard",75,"North Carolina Central",74,-1
2022-01-31,"Norfolk St.",67,"North Carolina Central",70,3
2022-02-05,"Coppin St.",68,"North Carolina Central",69,1
2021-11-09,"Milwaukee",75,"North Dakota",60,-15
2021-11-15,"Montana",77,"North Dakota",79,2
2021-11-19,"Troy",72,"North Dakota",74,2
2021-11-21,"Tennessee Martin",77,"North Dakota",72,-5
2021-11-30,"Presentation",55,"North Dakota",72,17
2021-12-11,"Eastern Washington",76,"North Dakota",60,-16
2021-12-14,"North Central MN",65,"North Dakota",110,45
2021-12-18,"Dixie St.",78,"North Dakota",69,-9
2022-01-10,"South Dakota",75,"North Dakota",68,-7
2022-01-13,"Western Illinois",73,"North Dakota",68,-5
2022-01-31,"South Dakota St.",70,"North Dakota",64,-6
2022-02-03,"Denver",81,"North Dakota",79,-2
2022-02-05,"Nebraska Omaha",85,"North Dakota",92,7
2021-11-09,"Concordia College MN",44,"North Dakota St.",88,44
2021-11-22,"Tarleton St.",53,"North Dakota St.",54,1
2021-11-27,"Idaho",73,"North Dakota St.",90,17
2021-12-02,"Northland",51,"North Dakota St.",114,63
2021-12-10,"Cal St. Northridge",54,"North Dakota St.",68,14
2021-12-13,"Indiana St.",70,"North Dakota St.",77,7
2021-12-22,"North Dakota",76,"North Dakota St.",86,10
2021-12-30,"South Dakota St.",90,"North Dakota St.",86,-4
2022-01-15,"Western Illinois",90,"North Dakota St.",79,-11
2022-01-25,"St. Thomas",56,"North Dakota St.",77,21
2022-02-03,"Nebraska Omaha",64,"North Dakota St.",71,7
2022-02-05,"Denver",65,"North Dakota St.",73,8
2022-02-07,"South Dakota",74,"North Dakota St.",76,2
2021-11-20,"Webber International",43,"North Florida",103,60
2021-12-02,"Edward Waters",57,"North Florida",103,46
2021-12-11,"Austin Peay",84,"North Florida",91,7
2021-12-18,"Trinity Baptist",44,"North Florida",92,48
2022-01-08,"Stetson",68,"North Florida",66,-2
2022-01-15,"Jacksonville",54,"North Florida",51,-3
2022-01-17,"Kennesaw St.",62,"North Florida",60,-2
2022-01-27,"Central Arkansas",74,"North Florida",93,19
2022-01-29,"Lipscomb",77,"North Florida",74,-3
2022-02-09,"Bellarmine",73,"North Florida",70,-3
2021-11-09,"Oklahoma Christian",53,"North Texas",84,31
2021-11-15,"Buffalo",69,"North Texas",66,-3
2021-11-18,"UT Arlington",36,"North Texas",64,28
2021-11-26,"Miami FL",69,"North Texas",63,-6
2021-12-04,"LSU Shreveport",35,"North Texas",73,38
2021-12-11,"Massachusetts",57,"North Texas",66,9
2021-12-14,"Sam Houston St.",55,"North Texas",65,10
2022-01-01,"Rice",43,"North Texas",75,32
2022-01-06,"UAB",69,"North Texas",63,-6
2022-01-08,"Middle Tennessee",63,"North Texas",70,7
2022-01-20,"Charlotte",51,"North Texas",65,14
2022-01-22,"Old Dominion",56,"North Texas",69,13
2022-02-05,"UTSA",45,"North Texas",69,24
2022-02-07,"UTEP",58,"North Texas",66,8
2021-11-16,"Boston University",48,"Northeastern",49,1
2021-11-22,"Colorado St.",71,"Northeastern",61,-10
2021-11-30,"Detroit Mercy",56,"Northeastern",66,10
2021-12-03,"Colgate",69,"Northeastern",74,5
2021-12-07,"Massachusetts",76,"Northeastern",82,6
2021-12-12,"Davidson",79,"Northeastern",69,-10
2022-01-15,"Drexel",76,"Northeastern",68,-8
2022-01-17,"Delaware",82,"Northeastern",76,-6
2022-01-22,"Hofstra",72,"Northeastern",50,-22
2022-01-24,"UNC Wilmington",74,"Northeastern",68,-6
2022-02-03,"James Madison",76,"Northeastern",71,-5
2022-02-05,"Towson",53,"Northeastern",58,5
2021-11-15,"Benedictine Mesa",48,"Northern Arizona",97,49
2021-11-18,"Cal St. Bakersfield",64,"Northern Arizona",74,10
2021-11-22,"UT Rio Grande Valley",82,"Northern Arizona",80,-2
2021-11-24,"Cal St. Fullerton",73,"Northern Arizona",56,-17
2021-12-18,"San Diego",69,"Northern Arizona",59,-10
2022-01-01,"Eastern Washington",78,"Northern Arizona",65,-13
2022-01-05,"Embry Riddle",54,"Northern Arizona",101,47
2022-01-17,"Idaho",72,"Northern Arizona",74,2
2022-01-20,"Montana St.",89,"Northern Arizona",84,-5
2022-01-22,"Montana",58,"Northern Arizona",48,-10
2022-01-24,"Sacramento St.",65,"Northern Arizona",70,5
2022-01-29,"Portland St.",97,"Northern Arizona",76,-21
2022-02-05,"Northern Colorado",74,"Northern Arizona",71,-3
2021-11-10,"Pacific",65,"Northern Colorado",67,2
2021-11-15,"Colorado College",53,"Northern Colorado",93,40
2021-12-02,"Montana St.",75,"Northern Colorado",77,2
2021-12-04,"Montana",75,"Northern Colorado",78,3
2021-12-07,"South Dakota",69,"Northern Colorado",74,5
2021-12-21,"Northern New Mexico",54,"Northern Colorado",90,36
2022-01-08,"Sacramento St.",85,"Northern Colorado",71,-14
2022-01-27,"Weber St.",85,"Northern Colorado",76,-9
2022-02-03,"Portland St.",106,"Northern Colorado",99,-7
2022-02-07,"Northern Arizona",60,"Northern Colorado",82,22
2021-11-21,"Boston University",76,"Northern Illinois",58,-18
2021-12-01,"Eastern Illinois",45,"Northern Illinois",55,10
2022-01-15,"Eastern Michigan",70,"Northern Illinois",77,7
2022-01-18,"Bowling Green",92,"Northern Illinois",83,-9
2022-01-27,"Ball St.",74,"Northern Illinois",67,-7
2022-01-29,"Central Michigan",69,"Northern Illinois",63,-6
2022-02-08,"Akron",70,"Northern Illinois",64,-6
2022-02-12,"Toledo",100,"Northern Illinois",72,-28
2021-11-09,"Nicholls St.",62,"Northern Iowa",58,-4
2021-11-11,"Vermont",71,"Northern Iowa",57,-14
2021-11-14,"Dubuque",58,"Northern Iowa",95,37
2021-12-05,"Richmond",60,"Northern Iowa",52,-8
2021-12-14,"Jackson St.",56,"Northern Iowa",66,10
2021-12-22,"Liberty",76,"Northern Iowa",74,-2
2022-01-02,"Evansville",61,"Northern Iowa",83,22
2022-01-05,"Valparaiso",65,"Northern Iowa",92,27
2022-01-11,"Indiana St.",74,"Northern Iowa",80,6
2022-01-22,"Drake",82,"Northern Iowa",74,-8
2022-01-29,"Illinois St.",64,"Northern Iowa",79,15
2022-02-02,"Bradley",65,"Northern Iowa",78,13
2022-02-09,"Southern Illinois",44,"Northern Iowa",53,9
2021-11-09,"Wheeling Jesuit",54,"Northern Kentucky",82,28
2021-11-12,"UNC Greensboro",70,"Northern Kentucky",69,-1
2021-11-18,"Eastern Michigan",73,"Northern Kentucky",74,1
2021-11-22,"Western Illinois",69,"Northern Kentucky",67,-2
2021-12-08,"Canisius",62,"Northern Kentucky",75,13
2021-12-12,"Alice Lloyd",55,"Northern Kentucky",91,36
2021-12-30,"Green Bay",74,"Northern Kentucky",79,5
2022-01-01,"Milwaukee",61,"Northern Kentucky",55,-6
2022-01-25,"Wright St.",63,"Northern Kentucky",73,10
2022-01-28,"Purdue Fort Wayne",49,"Northern Kentucky",59,10
2022-01-30,"Cleveland St.",72,"Northern Kentucky",78,6
2022-02-04,"Oakland",78,"Northern Kentucky",87,9
2022-02-05,"Detroit Mercy",74,"Northern Kentucky",68,-6
2021-11-09,"Eastern Illinois",56,"Northwestern",80,24
2021-11-12,"High Point",60,"Northwestern",95,35
2021-11-16,"New Orleans",67,"Northwestern",83,16
2021-11-18,"Fairleigh Dickinson",46,"Northwestern",82,36
2021-11-23,"Georgia",62,"Northwestern",78,16
2021-12-12,"NJIT",52,"Northwestern",70,18
2021-12-20,"Illinois Springfield",50,"Northwestern",90,40
2022-01-02,"Michigan St.",73,"Northwestern",67,-6
2022-01-05,"Penn St.",74,"Northwestern",70,-4
2022-01-12,"Maryland",94,"Northwestern",87,-7
2022-01-18,"Wisconsin",82,"Northwestern",76,-6
2022-01-29,"Illinois",59,"Northwestern",56,-3
2022-02-01,"Rutgers",78,"Northwestern",79,1
2022-02-08,"Indiana",51,"Northwestern",59,8
2021-11-13,"Champion Christian",62,"Northwestern St.",91,29
2021-11-19,"Louisiana Tech",83,"Northwestern St.",64,-19
2021-11-28,"Stephen F. Austin",72,"Northwestern St.",68,-4
2021-12-11,"Dallas Christian",67,"Northwestern St.",89,22
2021-12-18,"Southwestern Adventist",50,"Northwestern St.",104,54
2022-01-08,"New Orleans",80,"Northwestern St.",79,-1
2022-01-27,"Incarnate Word",70,"Northwestern St.",79,9
2022-01-29,"Texas A&M Corpus Chris",76,"Northwestern St.",90,14
2022-02-10,"Houston Baptist",76,"Northwestern St.",69,-7
2022-02-12,"McNeese St.",80,"Northwestern St.",75,-5
2021-11-13,"Cal St. Northridge",52,"Notre Dame",68,16
2021-11-16,"High Point",61,"Notre Dame",70,9
2021-11-22,"Saint Mary's",62,"Notre Dame",59,-3
2021-11-23,"Chaminade",64,"Notre Dame",90,26
2021-11-24,"Texas A&M",73,"Notre Dame",67,-6
2021-12-11,"Kentucky",62,"Notre Dame",66,4
2021-12-20,"Western Michigan",52,"Notre Dame",85,33
2021-12-22,"Texas A&M Corpus Chris",73,"Notre Dame",83,10
2022-01-05,"North Carolina",73,"Notre Dame",78,5
2022-01-12,"Clemson",56,"Notre Dame",72,16
2022-01-26,"N.C. State",65,"Notre Dame",73,8
2022-01-29,"Virginia",65,"Notre Dame",69,4
2022-01-31,"Duke",57,"Notre Dame",43,-14
2022-02-09,"Louisville",57,"Notre Dame",63,6
2021-11-17,"Toledo",59,"Oakland",80,21
2021-11-23,"Rice",73,"Oakland",76,3
2021-12-21,"Michigan St.",90,"Oakland",78,-12
2021-12-30,"Robert Morris",61,"Oakland",79,18
2022-01-01,"Youngstown St.",72,"Oakland",87,15
2022-01-07,"Ohio Christian",40,"Oakland",108,68
2022-01-09,"Milwaukee",65,"Oakland",86,21
2022-01-24,"Michigan Dearborn",61,"Oakland",104,43
2022-01-29,"Illinois Chicago",74,"Oakland",81,7
2021-11-09,"Belmont",80,"Ohio",92,12
2021-11-15,"Robert Morris",71,"Ohio",85,14
2021-11-22,"Mount St. Mary's",59,"Ohio",73,14
2021-11-26,"Concordia MI",68,"Ohio",88,20
2021-12-04,"St. Francis PA",75,"Ohio",78,3
2021-12-15,"Marshall",65,"Ohio",75,10
2021-12-21,"USC Upstate",70,"Ohio",85,15
2022-01-07,"Kent St.",72,"Ohio",80,8
2022-01-11,"Bowling Green",78,"Ohio",85,7
2022-01-21,"Toledo",87,"Ohio",69,-18
2022-01-25,"Northern Illinois",62,"Ohio",74,12
2022-02-01,"Ball St.",63,"Ohio",87,24
2022-02-03,"Eastern Michigan",68,"Ohio",81,13
2022-02-05,"Western Michigan",64,"Ohio",77,13
2021-11-09,"Akron",66,"Ohio St.",67,1
2021-11-12,"Niagara",74,"Ohio St.",84,10
2021-11-15,"Bowling Green",58,"Ohio St.",89,31
2021-11-30,"Duke",66,"Ohio St.",71,5
2021-12-08,"Towson",74,"Ohio St.",85,11
2021-12-11,"Wisconsin",55,"Ohio St.",73,18
2022-01-09,"Northwestern",87,"Ohio St.",95,8
2022-01-16,"Penn St.",56,"Ohio St.",61,5
2022-01-18,"IUPUI",37,"Ohio St.",83,46
2022-02-06,"Maryland",67,"Ohio St.",82,15
2021-11-09,"Northwestern St.",59,"Oklahoma",77,18
2021-11-12,"UTSA",44,"Oklahoma",96,52
2021-11-21,"Utah St.",73,"Oklahoma",70,-3
2021-11-24,"Houston Baptist",40,"Oklahoma",57,17
2021-12-01,"Florida",67,"Oklahoma",74,7
2021-12-07,"Butler",66,"Oklahoma",62,-4
2021-12-11,"Arkansas",66,"Oklahoma",88,22
2021-12-19,"UT Arlington",50,"Oklahoma",70,20
2021-12-22,"Alcorn St.",48,"Oklahoma",72,24
2022-01-01,"Kansas St.",69,"Oklahoma",71,2
2022-01-08,"Iowa St.",66,"Oklahoma",79,13
2022-01-18,"Kansas",67,"Oklahoma",64,-3
2022-01-22,"Baylor",65,"Oklahoma",51,-14
2022-01-31,"TCU",72,"Oklahoma",63,-9
2022-02-09,"Texas Tech",55,"Oklahoma",70,15
2021-11-09,"UT Arlington",45,"Oklahoma St.",88,43
2021-11-12,"Oakland",56,"Oklahoma St.",55,-1
2021-11-14,"Prairie View A&M",59,"Oklahoma St.",72,13
2021-11-16,"UMass Lowell",58,"Oklahoma St.",80,22
2021-11-17,"N.C. State",68,"Oklahoma St.",74,6
2021-11-22,"Charleston",66,"Oklahoma St.",96,30
2021-12-01,"Wichita St.",60,"Oklahoma St.",51,-9
2021-12-05,"Xavier",77,"Oklahoma St.",71,-6
2021-12-13,"Cleveland St.",93,"Oklahoma St.",98,5
2021-12-18,"Houston",72,"Oklahoma St.",61,-11
2022-01-04,"Kansas",74,"Oklahoma St.",63,-11
2022-01-08,"Texas",51,"Oklahoma St.",64,13
2022-01-19,"TCU",56,"Oklahoma St.",57,1
2022-01-26,"Iowa St.",84,"Oklahoma St.",81,-3
2022-02-05,"Oklahoma",55,"Oklahoma St.",64,9
2022-02-12,"West Virginia",58,"Oklahoma St.",81,23
2021-11-10,"Virginia Wesleyan",60,"Old Dominion",80,20
2021-11-15,"Manhattan",58,"Old Dominion",79,21
2021-11-18,"Indiana St.",77,"Old Dominion",36,-41
2021-11-19,"East Carolina",73,"Old Dominion",60,-13
2021-11-21,"Penn",71,"Old Dominion",63,-8
2021-11-26,"Longwood",61,"Old Dominion",62,1
2021-12-11,"VCU",75,"Old Dominion",66,-9
2021-12-22,"Charleston",82,"Old Dominion",80,-2
2022-01-13,"UTSA",51,"Old Dominion",83,32
2022-01-15,"UTEP",78,"Old Dominion",70,-8
2022-01-29,"Charlotte",52,"Old Dominion",68,16
2022-02-03,"Marshall",64,"Old Dominion",79,15
2022-02-05,"Western Kentucky",77,"Old Dominion",60,-17
2021-11-12,"Southwestern Christian",50,"Oral Roberts",121,71
2021-11-18,"Haskell",46,"Oral Roberts",89,43
2021-11-23,"Rogers St.",31,"Oral Roberts",91,60
2021-11-26,"Oklahoma St.",78,"Oral Roberts",77,-1
2021-11-29,"Tulsa",80,"Oral Roberts",87,7
2021-12-16,"UT Arlington",62,"Oral Roberts",71,9
2021-12-30,"Denver",66,"Oral Roberts",83,17
2022-01-01,"Nebraska Omaha",62,"Oral Roberts",107,45
2022-01-20,"North Dakota",76,"Oral Roberts",80,4
2022-01-22,"North Dakota St.",72,"Oral Roberts",71,-1
2022-02-03,"Western Illinois",90,"Oral Roberts",85,-5
2022-02-05,"St. Thomas",66,"Oral Roberts",88,22
2022-02-12,"UMKC",86,"Oral Roberts",91,5
2021-11-09,"Texas Southern",66,"Oregon",83,17
2021-11-12,"SMU",63,"Oregon",86,23
2021-11-16,"BYU",81,"Oregon",49,-32
2021-11-24,"Houston",78,"Oregon",49,-29
2021-11-29,"Montana",47,"Oregon",87,40
2021-12-01,"UC Riverside",65,"Oregon",71,6
2021-12-05,"Arizona St.",69,"Oregon",67,-2
2021-12-15,"Portland",71,"Oregon",96,25
2021-12-18,"Baylor",78,"Oregon",70,-8
2021-12-21,"Pepperdine",59,"Oregon",68,9
2022-01-01,"Utah",66,"Oregon",79,13
2022-01-23,"Washington",56,"Oregon",84,28
2022-01-25,"Colorado",82,"Oregon",78,-4
2022-01-29,"Oregon St.",56,"Oregon",78,22
2022-02-10,"Stanford",60,"Oregon",68,8
2022-02-12,"California",78,"Oregon",64,-14
2021-11-09,"Portland St.",64,"Oregon St.",73,9
2021-11-18,"Samford",78,"Oregon St.",77,-1
2021-11-21,"Princeton",81,"Oregon St.",80,-1
2021-11-27,"Penn St.",60,"Oregon St.",45,-15
2021-12-05,"Arizona",90,"Oregon St.",65,-25
2021-12-14,"UC Davis",71,"Oregon St.",64,-7
2021-12-18,"Texas A&M",83,"Oregon St.",73,-10
2021-12-21,"Nicholls St.",61,"Oregon St.",83,22
2021-12-30,"Utah",76,"Oregon St.",88,12
2022-01-10,"Oregon",78,"Oregon St.",76,-2
2022-01-20,"Washington",82,"Oregon St.",72,-10
2022-02-09,"California",63,"Oregon St.",61,-2
2022-02-12,"Stanford",76,"Oregon St.",65,-11
2021-11-11,"Hawaii Hilo",74,"Pacific",85,11
2021-11-16,"Cal St.Stanislaus",46,"Pacific",65,19
2021-11-19,"UTEP",73,"Pacific",64,-9
2021-11-22,"Chicago St.",58,"Pacific",74,16
2021-11-26,"Arkansas Pine Bluff",50,"Pacific",74,24
2021-12-14,"UC Santa Barbara",71,"Pacific",80,9
2021-12-17,"North Dakota St.",73,"Pacific",61,-12
2021-12-19,"UC Davis",77,"Pacific",67,-10
2022-01-12,"Santa Clara",84,"Pacific",70,-14
2022-01-22,"San Diego",73,"Pacific",65,-8
2022-01-29,"BYU",73,"Pacific",76,3
2022-02-03,"Pepperdine",76,"Pacific",81,5
2021-11-16,"Lafayette",57,"Penn",85,28
2021-11-19,"Davidson",72,"Penn",60,-12
2021-12-01,"Villanova",71,"Penn",56,-15
2022-01-02,"Brown",73,"Penn",77,4
2022-01-07,"Cornell",65,"Penn",79,14
2022-01-08,"Columbia",73,"Penn",69,-4
2022-01-15,"Dartmouth",68,"Penn",78,10
2022-01-22,"Yale",68,"Penn",76,8
2022-02-12,"Harvard",74,"Penn",82,8
2021-11-10,"Youngstown St.",59,"Penn St.",75,16
2021-11-18,"St. Francis NY",59,"Penn St.",74,15
2021-11-22,"Cornell",74,"Penn St.",85,11
2021-11-26,"LSU",68,"Penn St.",63,-5
2021-12-01,"Miami FL",63,"Penn St.",58,-5
2021-12-05,"Ohio St.",76,"Penn St.",64,-12
2021-12-08,"Wagner",54,"Penn St.",74,20
2022-01-02,"Indiana",58,"Penn St.",61,3
2022-01-08,"Purdue",74,"Penn St.",67,-7
2022-01-11,"Rutgers",49,"Penn St.",66,17
2022-01-31,"Iowa",86,"Penn St.",90,4
2022-02-08,"Michigan",58,"Penn St.",57,-1
2021-11-12,"Idaho St.",60,"Pepperdine",65,5
2021-11-15,"Utah Valley",86,"Pepperdine",74,-12
2021-11-17,"UC Davis",67,"Pepperdine",72,5
2021-11-24,"TCU",73,"Pepperdine",64,-9
2021-11-27,"Grand Canyon",59,"Pepperdine",56,-3
2021-12-06,"San Jose St.",69,"Pepperdine",82,13
2021-12-11,"Alabama St.",62,"Pepperdine",79,17
2021-12-18,"Southeast Missouri St.",77,"Pepperdine",83,6
2021-12-23,"Westmont",69,"Pepperdine",96,27
2022-01-10,"San Diego",72,"Pepperdine",62,-10
2022-01-13,"Saint Mary's",77,"Pepperdine",62,-15
2022-01-15,"Portland",82,"Pepperdine",63,-19
2022-01-22,"San Francisco",71,"Pepperdine",45,-26
2022-02-05,"Pacific",64,"Pepperdine",70,6
2022-02-12,"BYU",91,"Pepperdine",85,-6
2021-11-09,"The Citadel",78,"Pittsburgh",63,-15
2021-11-16,"UNC Wilmington",51,"Pittsburgh",59,8
2021-11-19,"Towson",59,"Pittsburgh",63,4
2021-11-24,"Vanderbilt",68,"Pittsburgh",52,-16
2021-11-27,"UMBC",87,"Pittsburgh",77,-10
2021-11-30,"Minnesota",54,"Pittsburgh",53,-1
2021-12-09,"Colgate",68,"Pittsburgh",71,3
2021-12-12,"Monmouth",56,"Pittsburgh",52,-4
2021-12-21,"Jacksonville",55,"Pittsburgh",64,9
2021-12-28,"Notre Dame",68,"Pittsburgh",67,-1
2022-01-08,"Boston College",67,"Pittsburgh",69,2
2022-01-15,"Louisville",53,"Pittsburgh",65,12
2022-01-19,"Virginia",66,"Pittsburgh",61,-5
2022-01-25,"Syracuse",53,"Pittsburgh",64,11
2022-02-05,"Virginia Tech",76,"Pittsburgh",71,-5
2022-02-12,"N.C. State",69,"Pittsburgh",71,2
2021-11-11,"Willamette",78,"Portland",122,44
2021-11-13,"Alcorn St.",58,"Portland",62,4
2021-11-18,"Arkansas Pine Bluff",74,"Portland",86,12
2021-11-20,"Morgan St.",63,"Portland",74,11
2021-11-27,"Southeast Missouri St.",68,"Portland",74,6
2021-12-03,"VMI",90,"Portland",82,-8
2021-12-13,"Cal Poly",77,"Portland",78,1
2021-12-17,"San Jose St.",90,"Portland",78,-12
2022-01-27,"Pacific",56,"Portland",64,8
2022-02-03,"Saint Mary's",75,"Portland",54,-21
2022-02-05,"San Francisco",74,"Portland",71,-3
2022-02-12,"Loyola Marymount",76,"Portland",86,10
2021-11-12,"Evergreen St.",44,"Portland St.",100,56
2021-11-17,"George Fox",58,"Portland St.",104,46
2021-11-23,"Portland",69,"Portland St.",54,-15
2021-12-11,"Cal Poly",61,"Portland St.",58,-3
2021-12-30,"Eastern Washington",63,"Portland St.",58,-5
2022-01-20,"Montana",66,"Portland St.",64,-2
2022-01-22,"Montana St.",73,"Portland St.",60,-13
2022-01-24,"Idaho",84,"Portland St.",79,-5
2022-01-27,"Southern Utah",85,"Portland St.",82,-3
2022-01-31,"Northern Colorado",76,"Portland St.",79,3
2022-02-05,"Sacramento St.",65,"Portland St.",73,8
2022-01-08,"Mississippi Valley St.",84,"Prairie View A&M",82,-2
2022-01-10,"Arkansas Pine Bluff",58,"Prairie View A&M",75,17
2022-01-22,"Alabama St.",67,"Prairie View A&M",70,3
2022-01-24,"Alabama A&M",48,"Prairie View A&M",72,24
2022-01-29,"Texas Southern",75,"Prairie View A&M",74,-1
2022-02-12,"Southern",77,"Prairie View A&M",84,7
2021-11-12,"VMI",72,"Presbyterian",73,1
2021-11-15,"The Citadel",70,"Presbyterian",74,4
2021-11-26,"Central Arkansas",66,"Presbyterian",75,9
2021-12-03,"Bob Jones",61,"Presbyterian",90,29
2021-12-15,"Carver",33,"Presbyterian",98,65
2021-12-18,"Wofford",76,"Presbyterian",49,-27
2021-12-30,"Truett McConnell",49,"Presbyterian",91,42
2022-01-08,"USC Upstate",82,"Presbyterian",72,-10
2022-01-20,"Winthrop",60,"Presbyterian",58,-2
2022-01-22,"Longwood",71,"Presbyterian",70,-1
2022-01-29,"UNC Asheville",68,"Presbyterian",67,-1
2022-02-02,"Campbell",58,"Presbyterian",64,6
2022-02-09,"High Point",79,"Presbyterian",70,-9
2021-11-09,"Rutgers Camden",28,"Princeton",94,66
2021-11-14,"Minnesota",87,"Princeton",80,-7
2021-11-17,"Marist",61,"Princeton",80,19
2021-11-28,"Fairleigh Dickinson",79,"Princeton",89,10
2021-12-04,"Drexel",79,"Princeton",81,2
2021-12-07,"Bucknell",69,"Princeton",82,13
2021-12-13,"UMBC",77,"Princeton",89,12
2021-12-21,"Kean",59,"Princeton",100,41
2022-01-07,"Columbia",69,"Princeton",84,15
2022-01-08,"Cornell",70,"Princeton",72,2
2022-01-15,"Brown",74,"Princeton",76,2
2022-01-17,"Penn",64,"Princeton",74,10
2022-01-29,"Yale",80,"Princeton",74,-6
2022-02-12,"Dartmouth",40,"Princeton",85,45
2021-11-09,"Fairfield",73,"Providence",80,7
2021-11-11,"Sacred Heart",64,"Providence",92,28
2021-11-18,"New Hampshire",58,"Providence",69,11
2021-11-22,"Northwestern",72,"Providence",77,5
2021-11-23,"Virginia",58,"Providence",40,-18
2021-11-27,"Saint Peter's",71,"Providence",85,14
2021-12-01,"Texas Tech",68,"Providence",72,4
2021-12-04,"Rhode Island",52,"Providence",66,14
2021-12-07,"Vermont",58,"Providence",68,10
2021-12-11,"Central Connecticut",53,"Providence",68,15
2021-12-29,"Seton Hall",65,"Providence",70,5
2022-01-08,"St. John's",73,"Providence",83,10
2022-01-20,"Georgetown",75,"Providence",83,8
2022-01-23,"Butler",62,"Providence",69,7
2022-01-30,"Marquette",63,"Providence",65,2
2022-02-12,"DePaul",73,"Providence",76,3
2021-11-09,"Bellarmine",67,"Purdue",96,29
2021-11-12,"Indiana St.",67,"Purdue",92,25
2021-11-16,"Wright St.",52,"Purdue",96,44
2021-11-20,"North Carolina",84,"Purdue",93,9
2021-11-21,"Villanova",74,"Purdue",80,6
2021-11-26,"Nebraska Omaha",40,"Purdue",97,57
2021-11-30,"Florida St.",65,"Purdue",93,28
2021-12-03,"Iowa",70,"Purdue",77,7
2021-12-20,"Incarnate Word",59,"Purdue",79,20
2021-12-29,"Nicholls St.",90,"Purdue",104,14
2022-01-03,"Wisconsin",74,"Purdue",69,-5
2022-01-14,"Nebraska",65,"Purdue",92,27
2022-01-23,"Northwestern",60,"Purdue",80,20
2022-01-30,"Ohio St.",78,"Purdue",81,3
2022-02-05,"Michigan",76,"Purdue",82,6
2022-02-08,"Illinois",68,"Purdue",84,16
2021-11-09,"Earlham",54,"Purdue Fort Wayne",103,49
2021-11-16,"Austin Peay",60,"Purdue Fort Wayne",65,5
2021-11-26,"Southeastern Louisiana",66,"Purdue Fort Wayne",74,8
2021-12-02,"Wright St.",86,"Purdue Fort Wayne",73,-13
2021-12-04,"Northern Kentucky",57,"Purdue Fort Wayne",71,14
2021-12-11,"Southeast Missouri St.",65,"Purdue Fort Wayne",78,13
2022-01-13,"Detroit Mercy",60,"Purdue Fort Wayne",62,2
2022-01-15,"Oakland",76,"Purdue Fort Wayne",68,-8
2022-01-17,"Michigan Dearborn",59,"Purdue Fort Wayne",102,43
2022-01-21,"Robert Morris",62,"Purdue Fort Wayne",86,24
2022-01-23,"Youngstown St.",71,"Purdue Fort Wayne",82,11
2022-02-04,"Milwaukee",60,"Purdue Fort Wayne",70,10
2022-02-06,"Green Bay",55,"Purdue Fort Wayne",71,16
2022-02-10,"IUPUI",57,"Purdue Fort Wayne",72,15
2022-02-12,"Illinois Chicago",66,"Purdue Fort Wayne",73,7
2021-11-12,"Western New England",52,"Quinnipiac",103,51
2021-11-15,"Holy Cross",68,"Quinnipiac",76,8
2021-11-20,"Central Connecticut",65,"Quinnipiac",76,11
2021-11-28,"Brown",72,"Quinnipiac",61,-11
2021-12-03,"Saint Peter's",69,"Quinnipiac",59,-10
2021-12-11,"Maine",47,"Quinnipiac",73,26
2021-12-31,"Niagara",68,"Quinnipiac",77,9
2022-01-16,"Fairfield",66,"Quinnipiac",72,6
2022-01-19,"Rider",67,"Quinnipiac",73,6
2022-01-23,"Iona",76,"Quinnipiac",61,-15
2022-01-28,"Marist",87,"Quinnipiac",94,7
2022-02-06,"Monmouth",76,"Quinnipiac",63,-13
2021-11-09,"Emory & Henry",72,"Radford",84,12
2021-11-20,"Navy",47,"Radford",33,-14
2021-11-24,"William & Mary",54,"Radford",67,13
2021-11-28,"Eastern Kentucky",75,"Radford",88,13
2021-11-30,"Kentucky Christian",70,"Radford",79,9
2022-01-08,"North Carolina A&T",73,"Radford",72,-1
2022-01-12,"Longwood",83,"Radford",75,-8
2022-01-19,"Hampton",51,"Radford",54,3
2022-01-22,"UNC Asheville",78,"Radford",74,-4
2022-02-02,"Charleston Southern",52,"Radford",64,12
2022-02-05,"Presbyterian",78,"Radford",70,-8
2021-11-09,"Boston University",62,"Rhode Island",71,9
2021-11-12,"Bryant",64,"Rhode Island",83,19
2021-11-17,"Boston College",49,"Rhode Island",57,8
2021-11-21,"Boston College",65,"Rhode Island",71,6
2021-11-27,"Georgia St.",59,"Rhode Island",94,35
2021-12-07,"Sacred Heart",62,"Rhode Island",72,10
2022-01-02,"American International",55,"Rhode Island",70,15
2022-01-12,"Saint Joseph's",64,"Rhode Island",75,11
2022-01-19,"La Salle",54,"Rhode Island",56,2
2022-01-22,"George Washington",63,"Rhode Island",61,-2
2022-01-25,"Richmond",70,"Rhode Island",63,-7
2022-02-05,"Massachusetts",78,"Rhode Island",67,-11
2022-02-12,"Davidson",65,"Rhode Island",72,7
2021-11-09,"Pepperdine",63,"Rice",82,19
2021-11-16,"Southern",63,"Rice",81,18
2021-11-30,"Texas St.",80,"Rice",69,-11
2021-12-04,"Jarvis Christian",62,"Rice",100,38
2021-12-16,"Incarnate Word",55,"Rice",85,30
2022-01-06,"Middle Tennessee",61,"Rice",65,4
2022-01-08,"UAB",80,"Rice",85,5
2022-01-20,"Old Dominion",69,"Rice",77,8
2022-01-22,"Charlotte",67,"Rice",64,-3
2022-02-03,"UTSA",78,"Rice",91,13
2022-02-05,"UTEP",72,"Rice",70,-2
2022-02-08,"Jarvis Christian",63,"Rice",98,35
2022-02-12,"North Texas",67,"Rice",44,-23
2021-11-09,"North Carolina Central",60,"Richmond",70,10
2021-11-12,"Utah St.",85,"Richmond",74,-11
2021-11-16,"Georgia St.",78,"Richmond",94,16
2021-11-22,"Hofstra",68,"Richmond",81,13
2021-11-25,"Maryland",86,"Richmond",80,-6
2021-12-11,"Toledo",69,"Richmond",72,3
2021-12-19,"Old Dominion",61,"Richmond",67,6
2021-12-22,"Bucknell",50,"Richmond",81,31
2021-12-30,"Saint Joseph's",83,"Richmond",56,-27
2022-01-05,"Massachusetts",72,"Richmond",80,8
2022-01-14,"Davidson",87,"Richmond",84,-3
2022-01-29,"VCU",64,"Richmond",62,-2
2022-02-04,"St. Bonaventure",61,"Richmond",71,10
2022-02-07,"George Mason",59,"Richmond",62,3
2022-02-12,"La Salle",63,"Richmond",77,14
2021-11-12,"Coppin St.",69,"Rider",81,12
2021-11-14,"Delaware St.",53,"Rider",63,10
2021-11-23,"Middle Tennessee",60,"Rider",54,-6
2021-12-05,"Marist",79,"Rider",67,-12
2021-12-20,"Gwynedd Mercy",57,"Rider",82,25
2022-01-14,"Quinnipiac",77,"Rider",70,-7
2022-01-16,"Saint Peter's",58,"Rider",51,-7
2022-01-28,"Fairfield",76,"Rider",65,-11
2022-01-30,"Canisius",62,"Rider",70,8
2022-02-08,"Manhattan",67,"Rider",76,9
2021-11-19,"Mount St. Mary's",74,"Robert Morris",70,-4
2021-12-08,"Lancaster Bible",51,"Robert Morris",99,48
2021-12-11,"Florida Gulf Coast",85,"Robert Morris",74,-11
2022-01-05,"Youngstown St.",64,"Robert Morris",60,-4
2022-01-07,"Cleveland St.",78,"Robert Morris",77,-1
2022-01-09,"Purdue Fort Wayne",76,"Robert Morris",70,-6
2022-01-13,"Wright St.",75,"Robert Morris",73,-2
2022-01-15,"Northern Kentucky",64,"Robert Morris",74,10
2022-01-27,"Milwaukee",53,"Robert Morris",77,24
2022-01-29,"Green Bay",60,"Robert Morris",62,2
2022-02-09,"Detroit Mercy",79,"Robert Morris",62,-17
2022-02-11,"Oakland",71,"Robert Morris",68,-3
2021-11-10,"Lehigh",70,"Rutgers",73,3
2021-11-13,"Merrimack",35,"Rutgers",48,13
2021-11-16,"NJIT",61,"Rutgers",75,14
2021-11-22,"Lafayette",53,"Rutgers",51,-2
2021-11-30,"Clemson",64,"Rutgers",74,10
2021-12-09,"Purdue",68,"Rutgers",70,2
2021-12-30,"Maine",64,"Rutgers",80,16
2022-01-01,"Central Connecticut",48,"Rutgers",79,31
2022-01-04,"Michigan",67,"Rutgers",75,8
2022-01-08,"Nebraska",65,"Rutgers",93,28
2022-01-19,"Iowa",46,"Rutgers",48,2
2022-01-25,"Maryland",68,"Rutgers",60,-8
2022-02-05,"Michigan St.",63,"Rutgers",84,21
2022-02-09,"Ohio St.",64,"Rutgers",66,2
2021-11-09,"William Jessup",59,"Sacramento St.",89,30
2021-11-20,"UC San Diego",71,"Sacramento St.",56,-15
2021-12-02,"Montana",65,"Sacramento St.",58,-7
2021-12-04,"Montana St.",68,"Sacramento St.",66,-2
2021-12-17,"Menlo",53,"Sacramento St.",67,14
2022-01-15,"Portland St.",67,"Sacramento St.",62,-5
2022-01-27,"Idaho St.",60,"Sacramento St.",61,1
2022-01-29,"Weber St.",79,"Sacramento St.",59,-20
2022-02-03,"Northern Arizona",62,"Sacramento St.",61,-1
2022-02-10,"Northern Colorado",79,"Sacramento St.",61,-18
2022-02-12,"Southern Utah",83,"Sacramento St.",57,-26
2021-11-14,"Binghamton",72,"Sacred Heart",60,-12
2021-11-16,"Fisher",49,"Sacred Heart",109,60
2021-11-20,"Fairfield",71,"Sacred Heart",61,-10
2021-12-22,"Hartford",78,"Sacred Heart",71,-7
2021-12-29,"LIU",65,"Sacred Heart",69,4
2022-01-15,"Fairleigh Dickinson",71,"Sacred Heart",77,6
2022-01-17,"Central Connecticut",66,"Sacred Heart",74,8
2022-01-27,"St. Francis NY",71,"Sacred Heart",66,-5
2022-02-10,"Bryant",99,"Sacred Heart",86,-13
2021-11-09,"Maryland Eastern Shore",67,"Saint Joseph's",69,2
2021-11-13,"Mount St. Mary's",60,"Saint Joseph's",80,20
2021-11-17,"Drexel",78,"Saint Joseph's",75,-3
2021-11-20,"Monmouth",87,"Saint Joseph's",75,-12
2021-12-01,"Binghamton",57,"Saint Joseph's",79,22
2021-12-08,"Penn",71,"Saint Joseph's",78,7
2021-12-11,"Temple",49,"Saint Joseph's",68,19
2022-01-05,"Davidson",88,"Saint Joseph's",73,-15
2022-01-17,"La Salle",75,"Saint Joseph's",64,-11
2022-01-19,"George Washington",61,"Saint Joseph's",72,11
2022-01-26,"Duquesne",61,"Saint Joseph's",72,11
2022-02-05,"Fordham",69,"Saint Joseph's",72,3
2021-11-09,"Central Arkansas",61,"Saint Louis",96,35
2021-11-10,"Harris Stowe",54,"Saint Louis",127,73
2021-11-12,"Eastern Illinois",44,"Saint Louis",86,42
2021-11-20,"Mercer",58,"Saint Louis",75,17
2021-11-23,"Illinois St.",76,"Saint Louis",82,6
2021-11-24,"Stephen F. Austin",68,"Saint Louis",79,11
2021-12-04,"UAB",77,"Saint Louis",72,-5
2021-12-07,"Belmont",64,"Saint Louis",59,-5
2021-12-11,"Boston College",68,"Saint Louis",79,11
2021-12-18,"Auburn",74,"Saint Louis",70,-4
2022-01-02,"Richmond",69,"Saint Louis",76,7
2022-01-08,"Iona",67,"Saint Louis",68,1
2022-01-15,"Fordham",45,"Saint Louis",63,18
2022-01-23,"Massachusetts",59,"Saint Louis",90,31
2022-01-26,"George Washington",67,"Saint Louis",80,13
2022-02-05,"Dayton",61,"Saint Louis",72,11
2022-02-11,"St. Bonaventure",68,"Saint Louis",61,-7
2021-11-09,"Prairie View A&M",68,"Saint Mary's",87,19
2021-11-12,"Texas Southern",58,"Saint Mary's",67,9
2021-11-15,"Southern Utah",51,"Saint Mary's",70,19
2021-11-17,"Bellarmine",64,"Saint Mary's",73,9
2021-11-23,"Oregon",50,"Saint Mary's",62,12
2021-11-24,"Wisconsin",61,"Saint Mary's",55,-6
2021-11-29,"UC Riverside",50,"Saint Mary's",67,17
2021-12-11,"UC Santa Barbara",59,"Saint Mary's",80,21
2021-12-14,"Cal St.Stanislaus",39,"Saint Mary's",76,37
2021-12-22,"Missouri St.",58,"Saint Mary's",75,17
2021-12-28,"Yale",60,"Saint Mary's",87,27
2022-01-20,"Santa Clara",65,"Saint Mary's",73,8
2022-01-29,"Pepperdine",57,"Saint Mary's",81,24
2022-02-05,"Loyola Marymount",60,"Saint Mary's",71,11
2022-02-10,"San Diego",57,"Saint Mary's",86,29
2021-11-23,"LIU",62,"Saint Peter's",64,2
2021-12-05,"Siena",60,"Saint Peter's",58,-2
2021-12-08,"St. Francis NY",71,"Saint Peter's",60,-11
2021-12-12,"Nyack",48,"Saint Peter's",87,39
2022-01-14,"Monmouth",62,"Saint Peter's",67,5
2022-01-18,"Canisius",57,"Saint Peter's",65,8
2022-01-28,"Manhattan",51,"Saint Peter's",77,26
2022-02-04,"Quinnipiac",74,"Saint Peter's",83,9
2022-02-06,"Marist",50,"Saint Peter's",66,16
2022-02-11,"Rider",58,"Saint Peter's",49,-9
2021-11-10,"LeTourneau",54,"Sam Houston St.",97,43
2021-11-17,"Missouri St.",77,"Sam Houston St.",55,-22
2021-11-21,"Little Rock",59,"Sam Houston St.",77,18
2021-11-22,"Boston University",72,"Sam Houston St.",59,-13
2021-12-02,"Schreiner",46,"Sam Houston St.",106,60
2021-12-11,"UTSA",78,"Sam Houston St.",73,-5
2021-12-18,"Hardin Simmons",53,"Sam Houston St.",103,50
2021-12-21,"Bradley",87,"Sam Houston St.",61,-26
2021-12-22,"North Carolina Central",51,"Sam Houston St.",68,17
2021-12-30,"Lamar",64,"Sam Houston St.",75,11
2022-01-03,"UT Rio Grande Valley",78,"Sam Houston St.",86,8
2022-01-15,"Stephen F. Austin",41,"Sam Houston St.",49,8
2022-01-20,"New Mexico St.",46,"Sam Houston St.",71,25
2022-01-22,"Grand Canyon",56,"Sam Houston St.",58,2
2022-02-03,"Dixie St.",53,"Sam Houston St.",77,24
2022-02-05,"Utah Valley",57,"Sam Houston St.",54,-3
2021-11-09,"Maryville TN",78,"Samford",99,21
2021-11-11,"Spring Hill",69,"Samford",86,17
2021-11-27,"McNeese St.",75,"Samford",83,8
2021-11-30,"Mississippi College",58,"Samford",83,25
2021-12-05,"Belmont",85,"Samford",73,-12
2021-12-11,"Alabama A&M",50,"Samford",52,2
2021-12-18,"Kennesaw St.",84,"Samford",85,1
2022-01-08,"Western Carolina",60,"Samford",85,25
2022-01-15,"East Tennessee St.",88,"Samford",85,-3
2022-01-26,"Mercer",61,"Samford",75,14
2022-02-02,"Chattanooga",72,"Samford",80,8
2022-02-09,"Wofford",60,"Samford",65,5
2021-11-09,"La Verne",38,"San Diego",103,65
2021-11-17,"UC Riverside",62,"San Diego",74,12
2021-11-19,"Cal St. Fullerton",57,"San Diego",55,-2
2021-11-28,"Cal St. Northridge",56,"San Diego",52,-4
2021-12-05,"Cal Poly",51,"San Diego",52,1
2021-12-11,"Cal Lutheran",55,"San Diego",84,29
2022-01-13,"Portland",63,"San Diego",68,5
2022-01-15,"Loyola Marymount",65,"San Diego",70,5
2022-01-27,"Pepperdine",56,"San Diego",64,8
2022-02-03,"Gonzaga",92,"San Diego",62,-30
2022-02-05,"Santa Clara",79,"San Diego",66,-13
2022-02-12,"Pacific",54,"San Diego",60,6
2021-11-09,"UC Riverside",53,"San Diego St.",66,13
2021-11-18,"Arizona St.",63,"San Diego St.",65,2
2021-11-20,"UT Arlington",62,"San Diego St.",68,6
2021-11-25,"Georgetown",56,"San Diego St.",73,17
2021-11-26,"USC",58,"San Diego St.",43,-15
2021-11-30,"Long Beach St.",47,"San Diego St.",72,25
2021-12-08,"Cal St. Fullerton",56,"San Diego St.",66,10
2021-12-17,"Saint Mary's",53,"San Diego St.",63,10
2021-12-22,"UC San Diego",57,"San Diego St.",78,21
2022-01-08,"Colorado St.",49,"San Diego St.",79,30
2022-01-22,"Boise St.",42,"San Diego St.",37,-5
2022-01-24,"UNLV",55,"San Diego St.",80,25
2022-01-31,"New Mexico",47,"San Diego St.",72,25
2022-02-06,"Nevada",63,"San Diego St.",65,2
2022-02-12,"Air Force",64,"San Diego St.",76,12
2021-11-09,"LIU",64,"San Francisco",98,34
2021-11-11,"Prairie View A&M",76,"San Francisco",92,16
2021-11-13,"Davidson",60,"San Francisco",65,5
2021-11-15,"Samford",55,"San Francisco",77,22
2021-11-18,"Nevada",70,"San Francisco",73,3
2021-11-22,"Morgan St.",67,"San Francisco",83,16
2021-11-26,"UAB",61,"San Francisco",63,2
2021-12-04,"UNLV",62,"San Francisco",83,21
2021-12-08,"Fresno St.",63,"San Francisco",71,8
2021-12-22,"Southern Illinois",52,"San Francisco",64,12
2021-12-28,"Academy of Art",78,"San Francisco",111,33
2022-01-06,"Loyola Chicago",79,"San Francisco",74,-5
2022-01-08,"San Diego",73,"San Francisco",88,15
2022-01-13,"Loyola Marymount",73,"San Francisco",97,24
2022-01-15,"BYU",71,"San Francisco",69,-2
2022-01-27,"Saint Mary's",72,"San Francisco",70,-2
2022-01-29,"Santa Clara",85,"San Francisco",88,3
2022-02-08,"Portland",69,"San Francisco",68,-1
2022-02-10,"Pepperdine",61,"San Francisco",105,44
2021-11-11,"Cal St. Fullerton",76,"San Jose St.",78,2
2021-11-23,"Northern Colorado",74,"San Jose St.",75,1
2021-11-30,"South Dakota",52,"San Jose St.",61,9
2021-12-03,"North Dakota",51,"San Jose St.",76,25
2021-12-11,"Pacific",66,"San Jose St.",78,12
2021-12-21,"Santa Clara",79,"San Jose St.",57,-22
2022-01-08,"Bethesda",43,"San Jose St.",118,75
2022-01-15,"Colorado St.",78,"San Jose St.",42,-36
2022-01-17,"UNLV",81,"San Jose St.",56,-25
2022-01-25,"Air Force",63,"San Jose St.",53,-10
2022-02-01,"Fresno St.",73,"San Jose St.",43,-30
2022-02-09,"San Diego St.",72,"San Jose St.",62,-10
2022-02-12,"Wyoming",74,"San Jose St.",52,-22
2021-11-09,"Cal St. Fullerton",77,"Santa Clara",84,7
2021-11-12,"Stanford",72,"Santa Clara",88,16
2021-11-16,"Nevada",74,"Santa Clara",96,22
2021-11-19,"Cal Poly",57,"Santa Clara",87,30
2021-11-24,"Fresno St.",59,"Santa Clara",52,-7
2021-11-27,"UC Irvine",69,"Santa Clara",64,-5
2021-11-30,"Hawaii",58,"Santa Clara",70,12
2021-12-04,"Louisiana Tech",78,"Santa Clara",75,-3
2021-12-07,"Mount St. Mary's",77,"Santa Clara",88,11
2021-12-17,"Florida A&M",66,"Santa Clara",80,14
2021-12-19,"Montana",64,"Santa Clara",79,15
2022-01-15,"Gonzaga",115,"Santa Clara",83,-32
2022-01-24,"San Diego",74,"Santa Clara",78,4
2022-01-27,"BYU",76,"Santa Clara",77,1
2022-01-31,"Pacific",59,"Santa Clara",81,22
2022-02-03,"Loyola Marymount",60,"Santa Clara",79,19
2022-02-08,"Saint Mary's",72,"Santa Clara",77,5
2022-02-12,"San Francisco",74,"Santa Clara",58,-16
2021-11-10,"Alcorn St.",66,"Seattle",69,3
2021-11-14,"Idaho St.",51,"Seattle",77,26
2021-11-18,"Morgan St.",80,"Seattle",93,13
2021-11-22,"Arkansas Pine Bluff",56,"Seattle",77,21
2021-11-23,"Pacific Lutheran",40,"Seattle",89,49
2021-11-27,"St. Thomas",64,"Seattle",81,17
2021-12-01,"McNeese St.",62,"Seattle",78,16
2021-12-05,"VMI",89,"Seattle",82,-7
2021-12-12,"UC San Diego",51,"Seattle",73,22
2021-12-22,"Northwest",68,"Seattle",100,32
2022-01-12,"Utah Valley",65,"Seattle",71,6
2022-01-15,"Dixie St.",68,"Seattle",79,11
2022-01-26,"Stephen F. Austin",62,"Seattle",70,8
2022-01-29,"Sam Houston St.",63,"Seattle",78,15
2022-02-10,"UT Rio Grande Valley",59,"Seattle",67,8
2022-02-12,"Lamar",50,"Seattle",76,26
2021-11-10,"Fairleigh Dickinson",49,"Seton Hall",93,44
2021-11-14,"Yale",44,"Seton Hall",80,36
2021-11-22,"Ohio St.",79,"Seton Hall",76,-3
2021-11-28,"Bethune Cookman",70,"Seton Hall",84,14
2021-12-01,"Wagner",63,"Seton Hall",85,22
2021-12-04,"Nyack",67,"Seton Hall",113,46
2021-12-09,"Texas",60,"Seton Hall",64,4
2021-12-12,"Rutgers",63,"Seton Hall",77,14
2022-01-01,"Villanova",73,"Seton Hall",67,-6
2022-01-08,"Connecticut",87,"Seton Hall",90,3
2022-01-24,"St. John's",84,"Seton Hall",63,-21
2022-01-26,"Marquette",73,"Seton Hall",63,-10
2022-02-04,"Creighton",55,"Seton Hall",74,19
2022-02-09,"Xavier",71,"Seton Hall",73,2
2021-11-13,"Delaware",83,"Siena",63,-20
2021-11-16,"Yale",82,"Siena",54,-28
2021-11-22,"Harvard",69,"Siena",72,3
2021-12-03,"Manhattan",77,"Siena",72,-5
2022-01-09,"Fairfield",62,"Siena",69,7
2022-01-28,"Niagara",56,"Siena",60,4
2022-01-30,"Quinnipiac",76,"Siena",85,9
2022-02-01,"Canisius",65,"Siena",73,8
2022-02-04,"Rider",74,"Siena",60,-14
2022-02-11,"Iona",64,"Siena",70,6
2021-11-15,"Knox",37,"SIU Edwardsville",75,38
2021-11-21,"St. Thomas",86,"SIU Edwardsville",73,-13
2021-12-08,"Purdue Fort Wayne",59,"SIU Edwardsville",80,21
2021-12-12,"UMKC",56,"SIU Edwardsville",60,4
2021-12-19,"William Woods",29,"SIU Edwardsville",84,55
2022-01-08,"Murray St.",74,"SIU Edwardsville",69,-5
2022-01-17,"Belmont",80,"SIU Edwardsville",64,-16
2022-01-27,"Tennessee St.",75,"SIU Edwardsville",70,-5
2022-02-07,"Southeast Missouri St.",76,"SIU Edwardsville",47,-29
2022-02-10,"Tennessee Martin",63,"SIU Edwardsville",71,8
2022-02-12,"Tennessee Tech",60,"SIU Edwardsville",61,1
2021-11-09,"McNeese St.",62,"SMU",86,24
2021-11-15,"Northwestern St.",48,"SMU",95,47
2021-11-18,"Southeastern Louisiana",61,"SMU",78,17
2021-11-21,"Missouri",80,"SMU",75,-5
2021-11-22,"Loyola Marymount",76,"SMU",70,-6
2021-11-24,"Sam Houston St.",66,"SMU",75,9
2021-11-28,"Louisiana Monroe",67,"SMU",74,7
2021-12-01,"UNLV",64,"SMU",83,19
2021-12-04,"Vanderbilt",72,"SMU",84,12
2021-12-08,"Dayton",69,"SMU",77,8
2022-01-02,"UCF",60,"SMU",72,12
2022-01-12,"South Florida",65,"SMU",77,12
2022-01-29,"Temple",61,"SMU",69,8
2022-02-09,"Houston",83,"SMU",85,2
2021-11-09,"Spring Hill",41,"South Alabama",102,61
2021-11-20,"Mobile",45,"South Alabama",78,33
2021-11-22,"William Carey",53,"South Alabama",96,43
2021-11-25,"San Diego",67,"South Alabama",68,1
2021-11-29,"Texas A&M Commerce",66,"South Alabama",69,3
2021-12-01,"Southern Miss",55,"South Alabama",85,30
2021-12-14,"Tarleton St.",62,"South Alabama",69,7
2021-12-21,"SIU Edwardsville",69,"South Alabama",84,15
2022-01-06,"Appalachian St.",72,"South Alabama",64,-8
2022-01-13,"Georgia St.",65,"South Alabama",74,9
2022-01-15,"Georgia Southern",67,"South Alabama",73,6
2022-01-27,"Troy",63,"South Alabama",82,19
2022-02-10,"Little Rock",46,"South Alabama",77,31
2022-02-12,"Arkansas St.",51,"South Alabama",70,19
2021-11-09,"USC Upstate",60,"South Carolina",78,18
2021-11-12,"Princeton",66,"South Carolina",62,-4
2021-11-14,"Western Kentucky",64,"South Carolina",75,11
2021-11-18,"UAB",63,"South Carolina",66,3
2021-11-23,"Wofford",74,"South Carolina",85,11
2021-11-28,"Rider",58,"South Carolina",65,7
2021-12-05,"Georgetown",67,"South Carolina",80,13
2021-12-12,"Florida St.",65,"South Carolina",66,1
2021-12-14,"Allen",51,"South Carolina",110,59
2021-12-22,"Army",75,"South Carolina",105,30
2022-01-04,"Auburn",81,"South Carolina",66,-15
2022-01-15,"Florida",71,"South Carolina",63,-8
2022-01-22,"Georgia",66,"South Carolina",83,17
2022-01-26,"Vanderbilt",61,"South Carolina",70,9
2022-02-05,"Tennessee",81,"South Carolina",57,-24
2022-02-08,"Kentucky",86,"South Carolina",76,-10
2021-11-13,"Lipscomb",93,"South Carolina St.",81,-12
2021-11-18,"St. Andrews Pres.",53,"South Carolina St.",67,14
2021-11-23,"USC Upstate",82,"South Carolina St.",78,-4
2021-11-28,"The Citadel",91,"South Carolina St.",79,-12
2021-12-10,"High Point",66,"South Carolina St.",67,1
2021-12-16,"Carver",46,"South Carolina St.",105,59
2021-12-18,"Tennessee St.",88,"South Carolina St.",90,2
2022-01-08,"Coppin St.",74,"South Carolina St.",65,-9
2022-01-10,"Morgan St.",88,"South Carolina St.",81,-7
2022-01-18,"Morris",67,"South Carolina St.",102,35
2022-01-29,"Norfolk St.",87,"South Carolina St.",69,-18
2022-01-31,"Howard",55,"South Carolina St.",58,3
2022-02-07,"North Carolina Central",68,"South Carolina St.",74,6
2021-11-11,"Air Force",53,"South Dakota",59,6
2021-11-19,"Southern",68,"South Dakota",71,3
2021-11-21,"Tennessee St.",66,"South Dakota",83,17
2021-11-23,"Presentation",58,"South Dakota",99,41
2021-12-03,"Waldorf",37,"South Dakota",93,56
2021-12-11,"Northern Arizona",71,"South Dakota",76,5
2021-12-15,"Bellarmine",64,"South Dakota",78,14
2021-12-20,"Oral Roberts",82,"South Dakota",73,-9
2021-12-22,"UMKC",68,"South Dakota",57,-11
2022-01-13,"Denver",71,"South Dakota",80,9
2022-01-15,"Nebraska Omaha",70,"South Dakota",105,35
2022-01-27,"North Dakota St.",74,"South Dakota",62,-12
2022-01-29,"North Dakota",58,"South Dakota",71,13
2022-02-05,"South Dakota St.",89,"South Dakota",79,-10
2021-11-09,"Bradley",65,"South Dakota St.",81,16
2021-11-17,"Montana St.",74,"South Dakota St.",91,17
2021-11-18,"Presentation",62,"South Dakota St.",99,37
2021-11-22,"Nevada",75,"South Dakota St.",102,27
2021-11-23,"Washington",87,"South Dakota St.",76,-11
2021-11-24,"George Mason",76,"South Dakota St.",80,4
2021-11-30,"Prairie View A&M",90,"South Dakota St.",99,9
2021-12-03,"Minnesota Morris",47,"South Dakota St.",112,65
2021-12-20,"UMKC",57,"South Dakota St.",89,32
2021-12-22,"Oral Roberts",76,"South Dakota St.",82,6
2022-01-08,"South Dakota",65,"South Dakota St.",84,19
2022-01-15,"Denver",62,"South Dakota St.",80,18
2022-01-27,"North Dakota",61,"South Dakota St.",96,35
2022-01-29,"North Dakota St.",76,"South Dakota St.",80,4
2022-02-12,"Nebraska Omaha",61,"South Dakota St.",82,21
2021-11-09,"Bethune Cookman",54,"South Florida",75,21
2021-11-13,"Georgia Southern",53,"South Florida",41,-12
2021-11-15,"North Carolina A&T",54,"South Florida",56,2
2021-11-19,"Auburn",58,"South Florida",52,-6
2021-11-24,"Hampton",52,"South Florida",58,6
2021-12-03,"South Carolina St.",65,"South Florida",64,-1
2021-12-14,"Austin Peay",51,"South Florida",60,9
2021-12-18,"Florida",66,"South Florida",55,-11
2021-12-22,"BYU",54,"South Florida",39,-15
2021-12-25,"Wyoming",77,"South Florida",57,-20
2022-01-05,"Houston",83,"South Florida",66,-17
2022-01-15,"UCF",51,"South Florida",75,24
2022-01-26,"SMU",74,"South Florida",54,-20
2022-02-07,"Temple",49,"South Florida",52,3
2022-02-09,"Cincinnati",70,"South Florida",59,-11
2021-11-13,"Youngstown St.",97,"Southeast Missouri St.",79,-18
2021-11-19,"Arkansas St.",72,"Southeast Missouri St.",60,-12
2021-11-22,"Missouri Baptist",63,"Southeast Missouri St.",71,8
2021-12-04,"Webster",64,"Southeast Missouri St.",76,12
2021-12-08,"Evansville",73,"Southeast Missouri St.",75,2
2022-01-01,"Austin Peay",79,"Southeast Missouri St.",98,19
2022-01-20,"Tennessee St.",63,"Southeast Missouri St.",85,22
2022-01-27,"Morehead St.",74,"Southeast Missouri St.",73,-1
2022-01-29,"SIU Edwardsville",77,"Southeast Missouri St.",85,8
2022-02-05,"Eastern Illinois",56,"Southeast Missouri St.",63,7
2022-02-12,"Belmont",81,"Southeast Missouri St.",72,-9
2021-11-12,"Southeastern Baptist",58,"Southeastern Louisiana",128,70
2021-11-14,"Paul Quinn",60,"Southeastern Louisiana",77,17
2021-11-22,"Ecclesia",79,"Southeastern Louisiana",121,42
2021-11-28,"Western Michigan",81,"Southeastern Louisiana",77,-4
2022-01-12,"Tougaloo",72,"Southeastern Louisiana",77,5
2022-01-15,"Northwestern St.",74,"Southeastern Louisiana",79,5
2022-01-27,"Texas A&M Corpus Chris",86,"Southeastern Louisiana",71,-15
2022-01-29,"Incarnate Word",68,"Southeastern Louisiana",78,10
2022-02-10,"McNeese St.",86,"Southeastern Louisiana",91,5
2022-02-12,"Houston Baptist",84,"Southeastern Louisiana",89,5
2021-11-23,"Ecclesia",53,"Southern",109,56
2021-12-09,"Lindsey Wilson",68,"Southern",86,18
2021-12-11,"Southeastern Louisiana",66,"Southern",72,6
2022-01-03,"Texas Southern",50,"Southern",63,13
2022-01-22,"Arkansas Pine Bluff",51,"Southern",99,48
2022-01-24,"Mississippi Valley St.",72,"Southern",100,28
2022-02-05,"Alabama A&M",64,"Southern",73,9
2022-02-07,"Alabama St.",58,"Southern",72,14
2021-11-12,"Austin Peay",55,"Southern Illinois",73,18
2021-11-21,"Northeastern",59,"Southern Illinois",47,-12
2021-11-22,"Creighton",66,"Southern Illinois",64,-2
2021-11-26,"Alcorn St.",59,"Southern Illinois",62,3
2021-12-04,"Southern Miss",41,"Southern Illinois",66,25
2021-12-15,"Southeast Missouri St.",55,"Southern Illinois",80,25
2021-12-18,"Maryville MO",55,"Southern Illinois",75,20
2021-12-28,"Grambling St.",64,"Southern Illinois",75,11
2022-01-15,"Northern Iowa",69,"Southern Illinois",68,-1
2022-01-17,"Drake",60,"Southern Illinois",59,-1
2022-01-19,"Indiana St.",55,"Southern Illinois",63,8
2022-01-27,"Loyola Chicago",44,"Southern Illinois",39,-5
2022-01-30,"Valparaiso",55,"Southern Illinois",77,22
2022-02-02,"Missouri St.",69,"Southern Illinois",54,-15
2022-02-12,"Evansville",62,"Southern Illinois",69,7
2021-11-09,"William Carey",67,"Southern Miss",81,14
2021-11-12,"Louisiana",66,"Southern Miss",45,-21
2021-11-21,"Lamar",75,"Southern Miss",82,7
2021-11-25,"UC San Diego",55,"Southern Miss",56,1
2021-12-14,"Jacksonville",62,"Southern Miss",51,-11
2022-01-16,"Louisiana Tech",76,"Southern Miss",62,-14
2022-01-19,"Southeastern Baptist",50,"Southern Miss",100,50
2022-01-27,"North Texas",63,"Southern Miss",54,-9
2022-01-29,"Rice",76,"Southern Miss",62,-14
2021-11-09,"Bethesda",74,"Southern Utah",116,42
2021-12-08,"Utah Valley",56,"Southern Utah",60,4
2021-12-11,"Saint Katherine",61,"Southern Utah",100,39
2021-12-22,"Dixie St.",59,"Southern Utah",87,28
2021-12-30,"Sacramento St.",51,"Southern Utah",64,13
2022-01-01,"Northern Colorado",91,"Southern Utah",81,-10
2022-01-17,"Portland St.",76,"Southern Utah",86,10
2022-01-22,"Idaho St.",74,"Southern Utah",86,12
2022-01-24,"Weber St.",92,"Southern Utah",84,-8
2022-01-31,"Northern Arizona",66,"Southern Utah",78,12
2022-02-03,"Idaho",59,"Southern Utah",75,16
2022-02-05,"Eastern Washington",72,"Southern Utah",84,12
2021-11-09,"Siena",47,"St. Bonaventure",75,28
2021-11-14,"Canisius",60,"St. Bonaventure",69,9
2021-11-27,"Northern Iowa",90,"St. Bonaventure",80,-10
2021-12-01,"Coppin St.",81,"St. Bonaventure",93,12
2021-12-04,"Buffalo",65,"St. Bonaventure",68,3
2021-12-08,"Loyola MD",71,"St. Bonaventure",84,13
2022-01-14,"VCU",53,"St. Bonaventure",73,20
2022-01-29,"Saint Joseph's",69,"St. Bonaventure",80,11
2022-02-01,"Davidson",81,"St. Bonaventure",76,-5
2022-02-08,"Fordham",51,"St. Bonaventure",76,25
2021-11-13,"St. Thomas",91,"St. Francis NY",73,-18
2021-11-26,"McNeese St.",71,"St. Francis NY",59,-12
2021-12-05,"Hartford",68,"St. Francis NY",55,-13
2021-12-14,"Medgar Evers",51,"St. Francis NY",113,62
2021-12-31,"Central Connecticut",67,"St. Francis NY",55,-12
2022-01-06,"St. Francis PA",53,"St. Francis NY",70,17
2022-01-08,"Mount St. Mary's",69,"St. Francis NY",61,-8
2022-01-17,"LIU",80,"St. Francis NY",65,-15
2022-01-30,"Wagner",72,"St. Francis NY",69,-3
2022-02-03,"Fairleigh Dickinson",64,"St. Francis NY",81,17
2022-02-05,"Sacred Heart",66,"St. Francis NY",62,-4
2021-11-15,"Franciscan",54,"St. Francis PA",100,46
2021-12-01,"Bucknell",67,"St. Francis PA",93,26
2021-12-22,"Robert Morris",75,"St. Francis PA",67,-8
2021-12-29,"Wagner",72,"St. Francis PA",64,-8
2021-12-31,"Fairleigh Dickinson",70,"St. Francis PA",62,-8
2022-01-21,"Central Connecticut",67,"St. Francis PA",68,1
2022-01-23,"Sacred Heart",74,"St. Francis PA",85,11
2022-02-03,"Bryant",89,"St. Francis PA",82,-7
2022-02-05,"Merrimack",65,"St. Francis PA",64,-1
2022-02-12,"Mount St. Mary's",54,"St. Francis PA",52,-2
2021-11-09,"Mississippi Valley St.",61,"St. John's",119,58
2021-11-13,"Saint Peter's",70,"St. John's",91,21
2021-11-20,"Fairleigh Dickinson",74,"St. John's",87,13
2021-11-23,"St. Francis NY",70,"St. John's",76,6
2021-11-27,"NJIT",68,"St. John's",77,9
2021-12-03,"Kansas",95,"St. John's",75,-20
2021-12-05,"Fordham",69,"St. John's",83,14
2021-12-09,"Monmouth",83,"St. John's",88,5
2021-12-12,"Colgate",64,"St. John's",82,18
2021-12-18,"Pittsburgh",59,"St. John's",57,-2
2022-01-05,"DePaul",84,"St. John's",89,5
2022-01-16,"Georgetown",69,"St. John's",88,19
2022-01-22,"Seton Hall",66,"St. John's",60,-6
2022-02-01,"Providence",86,"St. John's",82,-4
2022-02-08,"Villanova",75,"St. John's",69,-6
2021-12-02,"Crown",53,"St. Thomas",73,20
2021-12-11,"Montana St.",72,"St. Thomas",65,-7
2021-12-14,"Northland",50,"St. Thomas",109,59
2021-12-29,"North Central MN",45,"St. Thomas",97,52
2022-01-01,"Western Illinois",66,"St. Thomas",89,23
2022-01-06,"Oral Roberts",81,"St. Thomas",66,-15
2022-01-20,"South Dakota St.",92,"St. Thomas",77,-15
2022-01-22,"South Dakota",90,"St. Thomas",79,-11
2022-02-08,"UMKC",76,"St. Thomas",67,-9
2022-02-10,"North Dakota",78,"St. Thomas",70,-8
2022-02-12,"North Dakota St.",75,"St. Thomas",64,-11
2021-11-09,"Tarleton St.",50,"Stanford",62,12
2021-11-15,"San Jose St.",62,"Stanford",76,14
2021-11-17,"Valparaiso",60,"Stanford",74,14
2021-11-23,"North Carolina A&T",65,"Stanford",79,14
2021-12-12,"Oregon",69,"Stanford",72,3
2021-12-16,"Dartmouth",78,"Stanford",89,11
2021-12-19,"Texas",60,"Stanford",53,-7
2021-12-22,"Wyoming",63,"Stanford",66,3
2021-12-23,"Liberty",76,"Stanford",79,3
2022-01-11,"USC",69,"Stanford",75,6
2022-01-20,"Arizona",85,"Stanford",57,-28
2022-01-22,"Arizona St.",76,"Stanford",79,3
2022-02-01,"California",50,"Stanford",57,7
2022-02-03,"Washington St.",66,"Stanford",60,-6
2022-02-06,"Washington",69,"Stanford",87,18
2022-02-08,"UCLA",79,"Stanford",70,-9
2021-11-09,"LSU Alexandria",73,"Stephen F. Austin",82,9
2021-11-11,"Mary Hardin Baylor",63,"Stephen F. Austin",76,13
2021-11-14,"South Dakota St.",83,"Stephen F. Austin",71,-12
2021-11-19,"Middle Tennessee",74,"Stephen F. Austin",87,13
2021-12-01,"Lincoln CA",54,"Stephen F. Austin",90,36
2021-12-04,"Wiley",76,"Stephen F. Austin",100,24
2021-12-11,"Liberty",51,"Stephen F. Austin",63,12
2021-12-14,"Louisiana Monroe",82,"Stephen F. Austin",69,-13
2022-01-11,"UT Rio Grande Valley",75,"Stephen F. Austin",86,11
2022-01-17,"Lamar",78,"Stephen F. Austin",86,8
2022-01-20,"Grand Canyon",46,"Stephen F. Austin",71,25
2022-01-22,"New Mexico St.",72,"Stephen F. Austin",58,-14
2022-02-03,"Utah Valley",59,"Stephen F. Austin",78,19
2022-02-05,"Dixie St.",52,"Stephen F. Austin",81,29
2021-11-09,"Florida Memorial",67,"Stetson",74,7
2021-11-27,"Campbell",60,"Stetson",58,-2
2021-12-11,"Ohio",55,"Stetson",45,-10
2021-12-13,"Johnson FL",58,"Stetson",104,46
2021-12-16,"Charleston",59,"Stetson",67,8
2021-12-22,"Piedmont",53,"Stetson",97,44
2021-12-30,"Point",65,"Stetson",77,12
2022-01-04,"Liberty",75,"Stetson",59,-16
2022-01-15,"Kennesaw St.",77,"Stetson",49,-28
2022-01-18,"Florida Gulf Coast",93,"Stetson",91,-2
2022-01-27,"Bellarmine",72,"Stetson",47,-25
2022-01-29,"Eastern Kentucky",95,"Stetson",113,18
2022-02-09,"Jacksonville St.",57,"Stetson",63,6
2021-11-22,"Sacred Heart",72,"Stony Brook",75,3
2021-12-01,"American",57,"Stony Brook",80,23
2021-12-04,"Wagner",78,"Stony Brook",49,-29
2021-12-08,"Hofstra",62,"Stony Brook",79,17
2021-12-11,"Bryant",78,"Stony Brook",86,8
2021-12-14,"Central Connecticut",67,"Stony Brook",87,20
2021-12-18,"Saint Peter's",63,"Stony Brook",64,1
2021-12-29,"Farmingdale St.",57,"Stony Brook",87,30
2022-01-08,"Maine",72,"Stony Brook",80,8
2022-01-17,"UMBC",51,"Stony Brook",65,14
2022-01-26,"Vermont",80,"Stony Brook",67,-13
2022-02-02,"Binghamton",77,"Stony Brook",61,-16
2022-02-07,"New Hampshire",67,"Stony Brook",65,-2
2022-02-09,"UMass Lowell",85,"Stony Brook",87,2
2021-11-09,"Lafayette",63,"Syracuse",97,34
2021-11-14,"Drexel",60,"Syracuse",75,15
2021-11-20,"Colgate",100,"Syracuse",85,-15
2021-11-26,"Auburn",89,"Syracuse",68,-21
2021-11-30,"Indiana",110,"Syracuse",112,2
2021-12-07,"Villanova",67,"Syracuse",53,-14
2021-12-27,"Brown",62,"Syracuse",93,31
2021-12-29,"Cornell",68,"Syracuse",80,12
2022-01-01,"Virginia",74,"Syracuse",69,-5
2022-01-11,"Pittsburgh",61,"Syracuse",77,16
2022-01-15,"Florida St.",76,"Syracuse",71,-5
2022-01-18,"Clemson",78,"Syracuse",91,13
2022-01-29,"Wake Forest",72,"Syracuse",94,22
2022-02-05,"Louisville",69,"Syracuse",92,23
2021-11-19,"Paul Quinn",42,"Tarleton St.",69,27
2021-12-05,"Charleston Southern",59,"Tarleton St.",57,-2
2021-12-07,"Dallas Christian",65,"Tarleton St.",84,19
2021-12-08,"Southwestern Assemblie",75,"Tarleton St.",81,6
2021-12-17,"South Alabama",52,"Tarleton St.",65,13
2021-12-21,"Air Force",45,"Tarleton St.",67,22
2022-01-06,"Sam Houston St.",64,"Tarleton St.",75,11
2022-01-08,"Stephen F. Austin",71,"Tarleton St.",77,6
2022-01-20,"Cal Baptist",88,"Tarleton St.",84,-4
2022-01-22,"Seattle",76,"Tarleton St.",68,-8
2022-02-05,"Chicago St.",54,"Tarleton St.",57,3
2022-02-12,"Abilene Christian",77,"Tarleton St.",63,-14
2021-11-11,"McNeese St.",61,"TCU",77,16
2021-11-15,"Southern Miss",51,"TCU",83,32
2021-11-18,"Nicholls St.",50,"TCU",63,13
2021-11-22,"Santa Clara",85,"TCU",66,-19
2021-11-29,"Austin Peay",51,"TCU",68,17
2021-12-02,"Oral Roberts",63,"TCU",71,8
2021-12-08,"Utah",62,"TCU",76,14
2021-12-21,"Grambling St.",55,"TCU",90,35
2022-01-08,"Baylor",76,"TCU",64,-12
2022-01-15,"Oklahoma",58,"TCU",59,1
2022-01-25,"Texas",73,"TCU",50,-23
2022-01-29,"LSU",68,"TCU",77,9
2022-02-05,"Kansas St.",75,"TCU",63,-12
2022-02-08,"Oklahoma St.",73,"TCU",77,4
2021-11-10,"Maryland Eastern Shore",49,"Temple",72,23
2021-11-13,"USC",76,"Temple",71,-5
2021-11-18,"Clemson",75,"Temple",48,-27
2021-11-19,"Boise St.",82,"Temple",62,-20
2021-11-27,"Delaware",74,"Temple",75,1
2021-12-01,"La Salle",57,"Temple",73,16
2021-12-04,"Penn",72,"Temple",81,9
2021-12-15,"UCF",65,"Temple",48,-17
2021-12-22,"Delaware St.",48,"Temple",85,37
2022-01-02,"Houston",66,"Temple",61,-5
2022-01-08,"East Carolina",75,"Temple",78,3
2022-01-25,"Cincinnati",58,"Temple",61,3
2022-02-05,"Tulsa",58,"Temple",67,9
2021-11-09,"Tennessee Martin",62,"Tennessee",90,28
2021-11-14,"East Tennessee St.",62,"Tennessee",94,32
2021-11-20,"Villanova",71,"Tennessee",53,-18
2021-11-26,"Tennessee Tech",69,"Tennessee",80,11
2021-11-30,"Presbyterian",44,"Tennessee",86,42
2021-12-07,"Texas Tech",57,"Tennessee",52,-5
2021-12-11,"UNC Greensboro",36,"Tennessee",76,40
2021-12-14,"USC Upstate",52,"Tennessee",96,44
2021-12-22,"Arizona",73,"Tennessee",77,4
2022-01-05,"Mississippi",60,"Tennessee",66,6
2022-01-11,"South Carolina",46,"Tennessee",66,20
2022-01-22,"LSU",50,"Tennessee",64,14
2022-01-26,"Florida",71,"Tennessee",78,7
2022-02-01,"Texas A&M",80,"Tennessee",90,10
2022-02-12,"Vanderbilt",64,"Tennessee",73,9
2021-11-13,"Miami Hamilton",66,"Tennessee Martin",94,28
2021-11-20,"Troy",80,"Tennessee Martin",67,-13
2021-11-24,"Carver",43,"Tennessee Martin",103,60
2021-12-11,"Middle Tennessee",84,"Tennessee Martin",75,-9
2021-12-14,"UNC Asheville",68,"Tennessee Martin",79,11
2022-01-08,"Belmont",81,"Tennessee Martin",55,-26
2022-01-15,"Tennessee Tech",76,"Tennessee Martin",70,-6
2022-01-20,"Austin Peay",72,"Tennessee Martin",57,-15
2022-01-24,"SIU Edwardsville",70,"Tennessee Martin",76,6
2022-01-27,"Eastern Illinois",58,"Tennessee Martin",53,-5
2022-02-03,"Southeast Missouri St.",63,"Tennessee Martin",84,21
2022-02-05,"Tennessee St.",69,"Tennessee Martin",61,-8
2021-11-13,"Norfolk St.",66,"Tennessee St.",59,-7
2021-11-16,"Fisk",56,"Tennessee St.",111,55
2021-11-28,"Southern",82,"Tennessee St.",80,-2
2021-12-10,"IUPUI",44,"Tennessee St.",70,26
2021-12-21,"Campbellsville H'burg",66,"Tennessee St.",108,42
2022-01-06,"Tennessee Martin",94,"Tennessee St.",78,-16
2022-01-08,"Southeast Missouri St.",84,"Tennessee St.",95,11
2022-01-15,"Morehead St.",71,"Tennessee St.",64,-7
2022-01-17,"Tennessee Tech",64,"Tennessee St.",80,16
2022-01-22,"Austin Peay",61,"Tennessee St.",65,4
2022-02-03,"Belmont",88,"Tennessee St.",61,-27
2022-02-10,"Murray St.",73,"Tennessee St.",62,-11
2021-11-14,"Oakwood",68,"Tennessee Tech",109,41
2021-11-23,"Lipscomb",77,"Tennessee Tech",88,11
2021-11-30,"Chattanooga",82,"Tennessee Tech",65,-17
2021-12-11,"Troy",75,"Tennessee Tech",72,-3
2021-12-16,"Montreat",60,"Tennessee Tech",117,57
2022-01-20,"SIU Edwardsville",76,"Tennessee Tech",94,18
2022-01-27,"Murray St.",80,"Tennessee Tech",75,-5
2022-01-29,"Austin Peay",58,"Tennessee Tech",55,-3
2022-01-31,"Morehead St.",70,"Tennessee Tech",56,-14
2022-02-05,"Belmont",100,"Tennessee Tech",92,-8
2022-02-07,"Eastern Illinois",58,"Tennessee Tech",84,26
2021-11-09,"Houston Baptist",48,"Texas",92,44
2021-11-17,"Northern Colorado",49,"Texas",62,13
2021-11-20,"San Jose St.",45,"Texas",79,34
2021-11-24,"Cal Baptist",44,"Texas",68,24
2021-11-29,"Sam Houston St.",57,"Texas",73,16
2021-12-03,"UT Rio Grande Valley",58,"Texas",88,30
2021-12-14,"Arkansas Pine Bluff",31,"Texas",63,32
2021-12-22,"Alabama St.",48,"Texas",68,20
2021-12-28,"Incarnate Word",33,"Texas",78,45
2022-01-01,"West Virginia",59,"Texas",74,15
2022-01-11,"Oklahoma",52,"Texas",66,14
2022-01-18,"Kansas St.",66,"Texas",65,-1
2022-01-22,"Oklahoma St.",51,"Texas",56,5
2022-01-29,"Tennessee",51,"Texas",52,1
2022-02-05,"Iowa St.",41,"Texas",63,22
2022-02-07,"Kansas",76,"Texas",79,3
2021-11-10,"North Florida",46,"Texas A&M",64,18
2021-11-12,"Abilene Christian",80,"Texas A&M",81,1
2021-11-14,"Texas A&M Corpus Chris",65,"Texas A&M",86,21
2021-11-17,"Houston Baptist",39,"Texas A&M",73,34
2021-11-30,"New Orleans",65,"Texas A&M",85,20
2021-12-11,"TCU",68,"Texas A&M",64,-4
2021-12-21,"Northwestern St.",61,"Texas A&M",80,19
2021-12-27,"Dallas Christian",52,"Texas A&M",102,50
2021-12-29,"Central Arkansas",59,"Texas A&M",85,26
2022-01-08,"Arkansas",81,"Texas A&M",86,5
2022-01-11,"Mississippi",51,"Texas A&M",67,16
2022-01-19,"Kentucky",64,"Texas A&M",58,-6
2022-01-29,"South Carolina",74,"Texas A&M",63,-11
2022-02-05,"Missouri",70,"Texas A&M",66,-4
2022-02-08,"LSU",76,"Texas A&M",68,-8
2021-11-09,"Texas Lutheran",64,"Texas A&M Corpus Chris",102,38
2021-11-17,"Denver",67,"Texas A&M Corpus Chris",69,2
2021-11-27,"St. Mary's TX",73,"Texas A&M Corpus Chris",88,15
2021-12-04,"Southwestern",60,"Texas A&M Corpus Chris",111,51
2021-12-08,"UT Rio Grande Valley",69,"Texas A&M Corpus Chris",75,6
2021-12-18,"Lamar",53,"Texas A&M Corpus Chris",57,4
2021-12-31,"Sul Ross St.",49,"Texas A&M Corpus Chris",101,52
2022-01-06,"Northwestern St.",67,"Texas A&M Corpus Chris",89,22
2022-01-08,"McNeese St.",54,"Texas A&M Corpus Chris",67,13
2022-01-15,"Incarnate Word",64,"Texas A&M Corpus Chris",80,16
2022-01-20,"McNeese St.",56,"Texas A&M Corpus Chris",60,4
2022-01-22,"Houston Baptist",77,"Texas A&M Corpus Chris",71,-6
2022-02-03,"New Orleans",79,"Texas A&M Corpus Chris",70,-9
2022-01-08,"Arkansas Pine Bluff",71,"Texas Southern",90,19
2022-01-10,"Mississippi Valley St.",58,"Texas Southern",95,37
2022-01-22,"Alabama A&M",44,"Texas Southern",78,34
2022-01-24,"Alabama St.",66,"Texas Southern",73,7
2022-02-12,"Grambling St.",65,"Texas Southern",68,3
2021-11-24,"LeTourneau",47,"Texas St.",92,45
2021-12-05,"Denver",58,"Texas St.",71,13
2021-12-12,"Southwestern",54,"Texas St.",101,47
2021-12-15,"Lamar",47,"Texas St.",67,20
2021-12-18,"Paul Quinn",36,"Texas St.",75,39
2021-12-30,"Troy",78,"Texas St.",63,-15
2022-01-13,"Louisiana Monroe",56,"Texas St.",80,24
2022-01-15,"Louisiana",68,"Texas St.",72,4
2022-01-29,"UT Arlington",53,"Texas St.",58,5
2022-02-03,"Appalachian St.",66,"Texas St.",68,2
2022-02-05,"Coastal Carolina",64,"Texas St.",69,5
2021-11-09,"North Florida",74,"Texas Tech",89,15
2021-11-12,"Grambling St.",62,"Texas Tech",88,26
2021-11-15,"Prairie View A&M",49,"Texas Tech",84,35
2021-11-20,"Incarnate Word",62,"Texas Tech",84,22
2021-11-23,"Nebraska Omaha",40,"Texas Tech",96,56
2021-11-27,"Lamar",57,"Texas Tech",89,32
2021-12-14,"Arkansas St.",62,"Texas Tech",75,13
2021-12-22,"Eastern Washington",46,"Texas Tech",78,32
2021-12-28,"Alabama St.",53,"Texas Tech",75,22
2022-01-08,"Kansas",67,"Texas Tech",75,8
2022-01-13,"Oklahoma St.",57,"Texas Tech",78,21
2022-01-18,"Iowa St.",60,"Texas Tech",72,12
2022-01-22,"West Virginia",65,"Texas Tech",78,13
2022-01-29,"Mississippi St.",50,"Texas Tech",76,26
2022-02-01,"Texas",64,"Texas Tech",77,13
2022-02-12,"TCU",69,"Texas Tech",82,13
2021-11-12,"Morris",67,"The Citadel",108,41
2021-11-18,"Carver",49,"The Citadel",102,53
2021-12-06,"North Carolina Central",67,"The Citadel",80,13
2021-12-16,"St. Andrews Pres.",62,"The Citadel",102,40
2021-12-20,"South Carolina St.",74,"The Citadel",57,-17
2021-12-21,"Manhattan",77,"The Citadel",74,-3
2022-01-13,"UNC Greensboro",69,"The Citadel",74,5
2022-01-15,"VMI",90,"The Citadel",85,-5
2022-01-17,"Mercer",71,"The Citadel",64,-7
2022-01-26,"Western Carolina",66,"The Citadel",68,2
2022-01-29,"Chattanooga",75,"The Citadel",62,-13
2022-02-05,"Samford",93,"The Citadel",107,14
2021-11-13,"Detroit Mercy",73,"Toledo",81,8
2021-11-29,"Northwestern Ohio",36,"Toledo",106,70
2021-12-07,"Bradley",65,"Toledo",67,2
2021-12-21,"Marshall",63,"Toledo",95,32
2021-12-29,"Western Michigan",56,"Toledo",83,27
2022-01-08,"Northern Illinois",63,"Toledo",94,31
2022-01-18,"Ball St.",70,"Toledo",83,13
2022-01-25,"Buffalo",75,"Toledo",86,11
2022-01-28,"Akron",76,"Toledo",84,8
2022-02-08,"Ohio",62,"Toledo",77,15
2021-11-13,"Monmouth",79,"Towson",71,-8
2021-11-16,"Hampton",54,"Towson",78,24
2021-11-23,"Penn",61,"Towson",76,15
2021-11-25,"San Francisco",71,"Towson",61,-10
2021-11-26,"New Mexico",58,"Towson",73,15
2021-12-02,"LIU",63,"Towson",72,9
2021-12-14,"UNC Greensboro",64,"Towson",74,10
2022-01-09,"Northeastern",67,"Towson",70,3
2022-01-11,"Hofstra",66,"Towson",78,12
2022-01-20,"Charleston",67,"Towson",74,7
2022-01-22,"UNC Wilmington",81,"Towson",77,-4
2022-01-29,"Drexel",62,"Towson",66,4
2022-02-10,"William & Mary",60,"Towson",75,15
2022-02-12,"Elon",50,"Towson",86,36
2021-11-09,"Carver",42,"Troy",104,62
2021-11-16,"Jacksonville St.",65,"Troy",69,4
2021-12-01,"Rust",48,"Troy",81,33
2021-12-05,"Southeastern Louisiana",72,"Troy",68,-4
2021-12-14,"Alabama A&M",57,"Troy",66,9
2021-12-18,"Arkansas Baptist",64,"Troy",84,20
2022-01-06,"Coastal Carolina",59,"Troy",69,10
2022-01-08,"Appalachian St.",53,"Troy",68,15
2022-01-29,"South Alabama",68,"Troy",77,9
2022-02-10,"Arkansas St.",77,"Troy",79,2
2022-02-12,"Little Rock",66,"Troy",62,-4
2021-11-09,"Southeastern Louisiana",67,"Tulane",70,3
2021-11-13,"Southern",73,"Tulane",70,-3
2021-11-22,"Drexel",87,"Tulane",90,3
2021-11-23,"Toledo",68,"Tulane",67,-1
2021-12-04,"Alcorn St.",64,"Tulane",85,21
2021-12-07,"Charleston",86,"Tulane",72,-14
2021-12-29,"Memphis",84,"Tulane",85,1
2022-01-08,"South Florida",54,"Tulane",68,14
2022-01-15,"SMU",75,"Tulane",66,-9
2022-01-26,"Tulsa",63,"Tulane",97,34
2022-01-29,"Wichita St.",66,"Tulane",67,1
2022-02-05,"East Carolina",66,"Tulane",86,20
2022-02-12,"Temple",83,"Tulane",92,9
2021-11-10,"Northwestern St.",75,"Tulsa",82,7
2021-11-13,"Air Force",59,"Tulsa",58,-1
2021-11-15,"Oregon St.",58,"Tulsa",64,6
2021-11-20,"Rhode Island",71,"Tulsa",77,6
2021-11-21,"Utah",72,"Tulsa",58,-14
2021-11-26,"Little Rock",63,"Tulsa",77,14
2021-12-07,"Loyola Marymount",60,"Tulsa",55,-5
2021-12-11,"Southern Illinois",65,"Tulsa",69,4
2021-12-16,"Alcorn St.",62,"Tulsa",83,21
2021-12-29,"SMU",74,"Tulsa",69,-5
2022-01-12,"Temple",69,"Tulsa",64,-5
2022-01-15,"Houston",66,"Tulsa",64,-2
2022-01-23,"Memphis",83,"Tulsa",81,-2
2022-01-29,"South Florida",45,"Tulsa",76,31
2022-02-08,"East Carolina",73,"Tulsa",71,-2
2022-02-12,"Cincinnati",77,"Tulsa",83,6
2021-11-09,"UNC Asheville",77,"UAB",102,25
2021-11-12,"Morehead St.",71,"UAB",85,14
2021-11-14,"Rhodes",61,"UAB",98,37
2021-11-21,"Alabama A&M",41,"UAB",86,45
2021-11-25,"New Mexico",73,"UAB",86,13
2021-12-01,"East Tennessee St.",56,"UAB",70,14
2021-12-12,"Millsaps",29,"UAB",103,74
2021-12-14,"Grambling St.",61,"UAB",79,18
2021-12-18,"West Virginia",65,"UAB",59,-6
2021-12-22,"Mississippi Valley St.",58,"UAB",100,42
2021-12-30,"UTEP",62,"UAB",75,13
2022-01-01,"UTSA",59,"UAB",87,28
2022-01-13,"FIU",56,"UAB",84,28
2022-01-15,"Florida Atlantic",65,"UAB",76,11
2022-02-05,"Middle Tennessee",75,"UAB",97,22
2022-02-10,"Southern Miss",63,"UAB",84,21
2021-11-12,"Eastern Washington",76,"UC Davis",84,8
2021-11-23,"Sacramento St.",75,"UC Davis",63,-12
2021-11-28,"Academy of Art",79,"UC Davis",60,-19
2021-12-01,"Pacific",57,"UC Davis",63,6
2021-12-04,"California Merced",40,"UC Davis",81,41
2021-12-22,"Portland",65,"UC Davis",60,-5
2022-01-08,"UC San Diego",71,"UC Davis",78,7
2022-01-27,"Cal St. Fullerton",74,"UC Davis",58,-16
2022-01-29,"Long Beach St.",70,"UC Davis",63,-7
2022-02-05,"Hawaii",65,"UC Davis",68,3
2021-11-13,"Boise St.",50,"UC Irvine",58,8
2021-11-16,"La Verne",41,"UC Irvine",100,59
2021-11-20,"Pepperdine",48,"UC Irvine",82,34
2021-12-03,"Bethesda",54,"UC Irvine",86,32
2022-01-20,"Cal St. Fullerton",65,"UC Irvine",63,-2
2022-01-27,"Cal St. Bakersfield",52,"UC Irvine",57,5
2022-01-29,"Cal Poly",48,"UC Irvine",72,24
2022-02-10,"UC Riverside",56,"UC Irvine",66,10
2021-11-14,"La Sierra",54,"UC Riverside",72,18
2021-11-20,"Bethesda",57,"UC Riverside",95,38
2021-11-26,"Florida A&M",49,"UC Riverside",60,11
2021-12-12,"Cal Baptist",54,"UC Riverside",70,16
2022-01-06,"UC San Diego",51,"UC Riverside",59,8
2022-01-08,"UC Irvine",68,"UC Riverside",51,-17
2022-01-27,"Long Beach St.",68,"UC Riverside",62,-6
2022-01-29,"Cal St. Fullerton",54,"UC Riverside",67,13
2022-02-01,"UC Davis",65,"UC Riverside",60,-5
2022-02-03,"Hawaii",59,"UC Riverside",64,5
2021-11-13,"George Washington",55,"UC San Diego",75,20
2021-11-16,"San Diego Christian",60,"UC San Diego",97,37
2021-12-02,"Eastern Michigan",74,"UC San Diego",83,9
2021-12-18,"Cal Tech",52,"UC San Diego",93,41
2021-12-30,"UC Santa Barbara",83,"UC San Diego",85,2
2022-01-01,"Cal St. Northridge",64,"UC San Diego",72,8
2022-01-20,"Long Beach St.",87,"UC San Diego",69,-18
2022-01-27,"Cal Poly",59,"UC San Diego",55,-4
2022-01-29,"Cal St. Bakersfield",75,"UC San Diego",83,8
2022-02-12,"UC Riverside",62,"UC San Diego",85,23
2021-11-10,"San Francisco St.",65,"UC Santa Barbara",119,54
2021-11-20,"Chicago St.",50,"UC Santa Barbara",81,31
2021-11-24,"Arkansas Pine Bluff",58,"UC Santa Barbara",86,28
2021-11-29,"UT Arlington",70,"UC Santa Barbara",62,-8
2021-12-03,"Pepperdine",74,"UC Santa Barbara",86,12
2021-12-05,"Cal Lutheran",66,"UC Santa Barbara",87,21
2021-12-19,"Florida A&M",62,"UC Santa Barbara",73,11
2021-12-22,"Idaho St.",43,"UC Santa Barbara",56,13
2022-02-03,"UC Irvine",53,"UC Santa Barbara",52,-1
2022-02-05,"UC San Diego",48,"UC Santa Barbara",84,36
2021-11-10,"Robert Morris",59,"UCF",69,10
2021-11-16,"Jacksonville",54,"UCF",63,9
2021-11-27,"Oklahoma",65,"UCF",62,-3
2021-12-05,"Bethune Cookman",45,"UCF",81,36
2021-12-11,"North Carolina A&T",68,"UCF",83,15
2021-12-22,"North Alabama",64,"UCF",75,11
2021-12-30,"Michigan",71,"UCF",85,14
2022-01-05,"Temple",66,"UCF",62,-4
2022-01-12,"Memphis",64,"UCF",74,10
2022-01-22,"Tulane",66,"UCF",68,2
2022-01-29,"Houston",63,"UCF",49,-14
2022-02-03,"South Florida",49,"UCF",68,19
2022-02-08,"Wichita St.",66,"UCF",71,5
2021-11-09,"Cal St. Bakersfield",58,"UCLA",95,37
2021-11-12,"Villanova",77,"UCLA",86,9
2021-11-15,"Long Beach St.",79,"UCLA",100,21
2021-11-17,"North Florida",63,"UCLA",98,35
2021-11-22,"Bellarmine",62,"UCLA",75,13
2021-12-01,"Colorado",61,"UCLA",73,12
2022-01-06,"Long Beach St.",78,"UCLA",96,18
2022-01-13,"Oregon",84,"UCLA",81,-3
2022-01-15,"Oregon St.",65,"UCLA",81,16
2022-01-25,"Arizona",59,"UCLA",75,16
2022-01-27,"California",57,"UCLA",81,24
2022-01-29,"Stanford",43,"UCLA",66,23
2021-11-09,"Rivier",55,"UMass Lowell",91,36
2021-11-27,"Fisher",38,"UMass Lowell",101,63
2021-12-01,"Brown",73,"UMass Lowell",63,-10
2021-12-11,"Mass College of Libera",45,"UMass Lowell",109,64
2021-12-19,"Sacred Heart",62,"UMass Lowell",70,8
2022-01-06,"NJIT",77,"UMass Lowell",72,-5
2022-01-19,"Maine",62,"UMass Lowell",71,9
2022-01-26,"Albany",64,"UMass Lowell",62,-2
2022-02-05,"Vermont",78,"UMass Lowell",67,-11
2022-02-07,"Hartford",75,"UMass Lowell",85,10
2022-02-12,"UMBC",71,"UMass Lowell",88,17
2021-11-15,"Penn State York",47,"UMBC",85,38
2021-11-23,"American",67,"UMBC",98,31
2021-12-01,"Columbia",60,"UMBC",98,38
2021-12-16,"UNC Greensboro",62,"UMBC",51,-11
2022-01-08,"UMass Lowell",66,"UMBC",64,-2
2022-01-15,"Vermont",86,"UMBC",69,-17
2022-01-19,"Albany",66,"UMBC",54,-12
2022-01-26,"NJIT",69,"UMBC",73,4
2022-02-05,"New Hampshire",77,"UMBC",88,11
2022-02-09,"Hartford",64,"UMBC",68,4
2021-11-17,"Kansas Christian",36,"UMKC",99,63
2021-12-04,"Calvary",32,"UMKC",94,62
2021-12-10,"Green Bay",55,"UMKC",64,9
2022-01-10,"Nebraska Omaha",61,"UMKC",64,3
2022-01-11,"Baptist Christian",57,"UMKC",98,41
2022-01-15,"Oral Roberts",84,"UMKC",72,-12
2022-01-17,"Denver",63,"UMKC",55,-8
2022-01-20,"North Dakota St.",77,"UMKC",80,3
2022-01-22,"North Dakota",74,"UMKC",79,5
2022-01-24,"Spurgeon",44,"UMKC",111,67
2022-02-03,"St. Thomas",72,"UMKC",81,9
2022-02-05,"Western Illinois",82,"UMKC",91,9
2021-11-11,"Brevard",44,"UNC Asheville",101,57
2021-11-18,"Tennessee Tech",55,"UNC Asheville",61,6
2021-11-28,"St. Andrews Pres.",36,"UNC Asheville",106,70
2021-12-01,"The Citadel",58,"UNC Asheville",65,7
2021-12-04,"North Carolina Central",66,"UNC Asheville",82,16
2021-12-08,"Chattanooga",78,"UNC Asheville",73,-5
2021-12-18,"East Tennessee St.",64,"UNC Asheville",79,15
2021-12-21,"Milligan",54,"UNC Asheville",114,60
2022-01-08,"Charleston Southern",59,"UNC Asheville",82,23
2022-01-15,"USC Upstate",76,"UNC Asheville",73,-3
2022-01-19,"North Carolina A&T",73,"UNC Asheville",71,-2
2022-01-27,"Gardner Webb",61,"UNC Asheville",55,-6
2022-02-02,"Longwood",56,"UNC Asheville",48,-8
2022-02-09,"Hampton",53,"UNC Asheville",69,16
2021-11-09,"North Carolina A&T",53,"UNC Greensboro",57,4
2021-11-15,"Coppin St.",48,"UNC Greensboro",55,7
2021-11-24,"NC Wesleyan",61,"UNC Greensboro",80,19
2021-11-27,"Vermont",51,"UNC Greensboro",54,3
2021-11-30,"Elon",61,"UNC Greensboro",74,13
2022-01-05,"Furman",58,"UNC Greensboro",54,-4
2022-01-10,"Wofford",54,"UNC Greensboro",58,4
2022-01-20,"Chattanooga",72,"UNC Greensboro",64,-8
2022-01-22,"Samford",58,"UNC Greensboro",61,3
2022-02-02,"VMI",76,"UNC Greensboro",65,-11
2022-02-10,"The Citadel",66,"UNC Greensboro",86,20
2021-11-12,"Guilford",68,"UNC Wilmington",77,9
2021-11-18,"Coastal Carolina",53,"UNC Wilmington",65,12
2021-11-24,"Southern Miss",80,"UNC Wilmington",66,-14
2021-12-01,"Norfolk St.",74,"UNC Wilmington",69,-5
2021-12-15,"Mount Olive",55,"UNC Wilmington",85,30
2021-12-22,"Campbell",58,"UNC Wilmington",65,7
2021-12-29,"Delaware",68,"UNC Wilmington",70,2
2022-01-12,"Elon",66,"UNC Wilmington",73,7
2022-01-27,"Northeastern",62,"UNC Wilmington",67,5
2022-01-29,"Hofstra",72,"UNC Wilmington",78,6
2022-01-31,"Drexel",63,"UNC Wilmington",70,7
2022-02-12,"Charleston",79,"UNC Wilmington",85,6
2021-11-10,"Gardner Webb",58,"UNLV",64,6
2021-11-13,"California",52,"UNLV",55,3
2021-11-15,"North Dakota St.",62,"UNLV",64,2
2021-11-19,"Michigan",74,"UNLV",61,-13
2021-11-21,"Wichita St.",74,"UNLV",73,-1
2021-11-24,"Whittier",45,"UNLV",101,56
2021-11-27,"UCLA",73,"UNLV",51,-22
2021-12-08,"Seattle",56,"UNLV",76,20
2021-12-11,"Hartford",78,"UNLV",95,17
2021-12-15,"Nebraska Omaha",71,"UNLV",84,13
2021-12-22,"San Diego",57,"UNLV",80,23
2022-01-01,"San Diego St.",62,"UNLV",55,-7
2022-01-11,"New Mexico",56,"UNLV",85,29
2022-01-14,"Fresno St.",73,"UNLV",68,-5
2022-01-22,"San Jose St.",62,"UNLV",70,8
2022-02-01,"Nevada",58,"UNLV",69,11
2022-02-08,"Air Force",44,"UNLV",78,34
2021-11-09,"Cal St. Northridge",49,"USC",89,40
2021-11-22,"Dixie St.",71,"USC",98,27
2021-11-25,"Saint Joseph's",55,"USC",70,15
2021-12-01,"Utah",73,"USC",93,20
2021-12-07,"Eastern Kentucky",68,"USC",80,12
2021-12-12,"Long Beach St.",62,"USC",73,11
2021-12-15,"UC Irvine",61,"USC",66,5
2021-12-18,"Georgia Tech",53,"USC",67,14
2022-01-13,"Oregon St.",71,"USC",81,10
2022-01-15,"Oregon",79,"USC",69,-10
2022-01-24,"Arizona St.",56,"USC",78,22
2022-01-27,"Stanford",64,"USC",61,-3
2022-01-29,"California",72,"USC",79,7
2022-02-08,"Pacific",68,"USC",74,6
2022-02-12,"UCLA",64,"USC",67,3
2021-11-15,"St. Andrews Pres.",43,"USC Upstate",96,53
2021-11-27,"Furman",87,"USC Upstate",77,-10
2021-12-01,"North Carolina Central",67,"USC Upstate",65,-2
2021-12-04,"Western Carolina",78,"USC Upstate",73,-5
2021-12-18,"Converse",38,"USC Upstate",78,40
2022-01-06,"Radford",82,"USC Upstate",77,-5
2022-01-12,"High Point",65,"USC Upstate",66,1
2022-01-22,"Charleston Southern",57,"USC Upstate",70,13
2022-01-26,"Winthrop",95,"USC Upstate",91,-4
2022-02-05,"Campbell",80,"USC Upstate",71,-9
2022-02-12,"UNC Asheville",83,"USC Upstate",56,-27
2021-11-13,"Mary Hardin Baylor",75,"UT Arlington",104,29
2021-11-16,"Abilene Christian",80,"UT Arlington",71,-9
2021-12-11,"Lamar",47,"UT Arlington",56,9
2021-12-22,"Howard Payne",46,"UT Arlington",95,49
2021-12-30,"South Alabama",87,"UT Arlington",89,2
2022-01-01,"Troy",57,"UT Arlington",62,5
2022-01-13,"Louisiana",73,"UT Arlington",83,10
2022-01-15,"Louisiana Monroe",62,"UT Arlington",55,-7
2022-01-27,"Texas St.",58,"UT Arlington",70,12
2022-02-05,"Appalachian St.",70,"UT Arlington",61,-9
2021-11-09,"Texas A&M Intl",59,"UT Rio Grande Valley",74,15
2021-11-16,"Paul Quinn",68,"UT Rio Grande Valley",85,17
2021-11-20,"Northern Arizona",89,"UT Rio Grande Valley",87,-2
2021-11-23,"Cal St. Fullerton",67,"UT Rio Grande Valley",72,5
2021-12-01,"Texas A&M Corpus Chris",83,"UT Rio Grande Valley",77,-6
2021-12-14,"Texas Southern",70,"UT Rio Grande Valley",60,-10
2022-01-06,"Grand Canyon",84,"UT Rio Grande Valley",70,-14
2022-01-08,"New Mexico St.",85,"UT Rio Grande Valley",73,-12
2022-01-13,"Chicago St.",63,"UT Rio Grande Valley",85,22
2022-01-26,"Abilene Christian",87,"UT Rio Grande Valley",85,-2
2022-01-29,"Tarleton St.",79,"UT Rio Grande Valley",64,-15
2022-02-02,"Lamar",79,"UT Rio Grande Valley",93,14
2021-11-09,"Abilene Christian",56,"Utah",70,14
2021-11-13,"Sacramento St.",56,"Utah",89,33
2021-11-15,"Bethune Cookman",55,"Utah",86,31
2021-11-27,"BYU",75,"Utah",64,-11
2021-12-05,"California",58,"Utah",66,8
2021-12-11,"Manhattan",62,"Utah",96,34
2021-12-21,"Fresno St.",50,"Utah",55,5
2022-01-06,"Washington",74,"Utah",68,-6
2022-01-08,"Washington St.",77,"Utah",61,-16
2022-01-20,"UCLA",63,"Utah",58,-5
2022-01-22,"USC",79,"Utah",67,-12
2022-02-03,"Oregon St.",59,"Utah",84,25
2022-02-05,"Oregon",80,"Utah",77,-3
2021-11-09,"UC Davis",72,"Utah St.",69,-3
2021-11-18,"Penn",79,"Utah St.",87,8
2021-11-19,"New Mexico St.",58,"Utah St.",85,27
2021-11-27,"UT Arlington",61,"Utah St.",80,19
2021-11-29,"Carroll MT",63,"Utah St.",93,30
2021-12-02,"Saint Mary's",60,"Utah St.",58,-2
2021-12-11,"New Orleans",50,"Utah St.",82,32
2021-12-21,"Portland St.",62,"Utah St.",81,19
2022-01-15,"Wyoming",71,"Utah St.",69,-2
2022-01-20,"Boise St.",62,"Utah St.",59,-3
2022-01-26,"San Diego St.",57,"Utah St.",75,18
2022-02-01,"Air Force",46,"Utah St.",73,27
2022-02-03,"San Jose St.",62,"Utah St.",78,16
2022-02-05,"UNLV",75,"Utah St.",90,15
2022-02-11,"Nevada",85,"Utah St.",72,-13
2021-11-12,"Antelope Valley",48,"Utah Valley",82,34
2021-11-24,"Nicholls St.",63,"Utah Valley",74,11
2021-11-27,"Denver",68,"Utah Valley",77,9
2021-12-01,"BYU",65,"Utah Valley",72,7
2021-12-17,"Bethesda",65,"Utah Valley",107,42
2021-12-30,"Abilene Christian",80,"Utah Valley",76,-4
2022-01-01,"Tarleton St.",55,"Utah Valley",77,22
2022-01-08,"Dixie St.",71,"Utah Valley",79,8
2022-01-20,"UT Rio Grande Valley",56,"Utah Valley",66,10
2022-01-22,"Lamar",41,"Utah Valley",58,17
2022-02-10,"Grand Canyon",79,"Utah Valley",69,-10
2022-02-12,"New Mexico St.",68,"Utah Valley",72,4
2021-11-09,"Western New Mexico",57,"UTEP",85,28
2021-11-16,"Northern New Mexico",53,"UTEP",88,35
2021-11-22,"UC Riverside",52,"UTEP",40,-12
2021-11-24,"Florida A&M",53,"UTEP",67,14
2021-12-03,"New Mexico St.",72,"UTEP",69,-3
2021-12-16,"McNeese St.",72,"UTEP",82,10
2021-12-21,"North Carolina Central",61,"UTEP",70,9
2021-12-22,"Bradley",73,"UTEP",66,-7
2022-01-06,"Louisiana Tech",64,"UTEP",52,-12
2022-01-08,"Southern Miss",54,"UTEP",87,33
2022-01-20,"UTSA",64,"UTEP",69,5
2022-01-27,"Florida Atlantic",68,"UTEP",70,2
2022-01-29,"FIU",68,"UTEP",79,11
2021-11-09,"Trinity TX",66,"UTSA",97,31
2021-11-15,"Texas A&M Commerce",65,"UTSA",62,-3
2021-11-16,"Denver",64,"UTSA",78,14
2021-11-17,"IUPUI",57,"UTSA",60,3
2021-11-21,"Texas A&M Corpus Chris",77,"UTSA",58,-19
2021-11-24,"Lamar",73,"UTSA",79,6
2021-11-29,"St. Mary's TX",65,"UTSA",75,10
2021-12-17,"UT Rio Grande Valley",68,"UTSA",50,-18
2022-01-03,"Dallas Christian",48,"UTSA",101,53
2022-01-06,"Southern Miss",74,"UTSA",73,-1
2022-01-08,"Louisiana Tech",79,"UTSA",63,-16
2022-01-23,"UTEP",59,"UTSA",54,-5
2022-01-27,"FIU",66,"UTSA",73,7
2022-01-29,"Florida Atlantic",73,"UTSA",64,-9
2022-02-12,"Western Kentucky",71,"UTSA",65,-6
2021-11-09,"Toledo",69,"Valparaiso",61,-8
2021-11-13,"Illinois Chicago",74,"Valparaiso",70,-4
2021-11-24,"Tulane",64,"Valparaiso",68,4
2021-11-27,"Trinity Christian",69,"Valparaiso",106,37
2021-12-07,"East West",58,"Valparaiso",101,43
2021-12-11,"Charlotte",68,"Valparaiso",67,-1
2021-12-20,"Eastern Michigan",55,"Valparaiso",67,12
2021-12-22,"William & Mary",66,"Valparaiso",88,22
2022-01-02,"Illinois St.",76,"Valparaiso",81,5
2022-01-08,"Southern Illinois",63,"Valparaiso",60,-3
2022-01-15,"Missouri St.",74,"Valparaiso",57,-17
2022-01-19,"Northern Iowa",80,"Valparaiso",83,3
2022-01-26,"Bradley",71,"Valparaiso",56,-15
2022-02-05,"Indiana St.",72,"Valparaiso",79,7
2021-11-10,"Alabama St.",72,"Vanderbilt",91,19
2021-11-14,"Texas St.",60,"Vanderbilt",79,19
2021-11-17,"VCU",48,"Vanderbilt",37,-11
2021-11-20,"Winthrop",63,"Vanderbilt",77,14
2021-11-29,"Mississippi Valley St.",36,"Vanderbilt",75,39
2021-12-07,"Temple",72,"Vanderbilt",68,-4
2021-12-10,"Loyola Chicago",69,"Vanderbilt",58,-11
2021-12-18,"Austin Peay",51,"Vanderbilt",77,26
2021-12-23,"BYU",67,"Vanderbilt",69,2
2022-01-08,"South Carolina",72,"Vanderbilt",70,-2
2022-01-11,"Kentucky",78,"Vanderbilt",66,-12
2022-01-18,"Tennessee",68,"Vanderbilt",60,-8
2022-01-29,"Georgia",77,"Vanderbilt",85,8
2022-02-05,"LSU",66,"Vanderbilt",75,9
2022-02-08,"Missouri",62,"Vanderbilt",70,8
2021-11-09,"Saint Peter's",54,"VCU",57,3
2021-11-13,"Wagner",58,"VCU",44,-14
2021-11-20,"Chattanooga",56,"VCU",54,-2
2021-11-24,"Syracuse",55,"VCU",67,12
2021-11-26,"Connecticut",70,"VCU",63,-7
2021-12-04,"Campbell",61,"VCU",65,4
2021-12-08,"Jacksonville St.",52,"VCU",66,14
2021-12-15,"Florida Atlantic",46,"VCU",66,20
2022-01-11,"George Washington",57,"VCU",84,27
2022-01-18,"Davidson",63,"VCU",61,-2
2022-01-22,"Saint Joseph's",54,"VCU",70,16
2022-02-02,"Dayton",82,"VCU",52,-30
2022-02-05,"Duquesne",62,"VCU",71,9
2022-02-08,"Rhode Island",64,"VCU",73,9
2021-11-16,"Worcester Tech",48,"Vermont",81,33
2021-11-19,"Yale",53,"Vermont",61,8
2021-11-22,"Oakland",63,"Vermont",61,-2
2021-11-23,"Evansville",49,"Vermont",58,9
2021-12-01,"Dartmouth",65,"Vermont",83,18
2021-12-22,"Colgate",68,"Vermont",78,10
2022-01-06,"New Hampshire",68,"Vermont",82,14
2022-01-12,"Stony Brook",65,"Vermont",98,33
2022-01-22,"Hartford",72,"Vermont",82,10
2022-01-29,"Maine",68,"Vermont",81,13
2022-01-31,"Albany",61,"Vermont",73,12
2022-02-02,"NJIT",67,"Vermont",90,23
2022-02-09,"Binghamton",51,"Vermont",82,31
2021-11-09,"Mount St. Mary's",51,"Villanova",91,40
2021-11-16,"Howard",81,"Villanova",100,19
2021-12-04,"Saint Joseph's",52,"Villanova",81,29
2021-12-21,"Xavier",58,"Villanova",71,13
2022-01-05,"Creighton",41,"Villanova",75,34
2022-01-16,"Butler",42,"Villanova",82,40
2022-01-19,"Marquette",57,"Villanova",54,-3
2022-01-25,"DePaul",43,"Villanova",67,24
2022-01-29,"St. John's",62,"Villanova",73,11
2022-02-05,"Connecticut",74,"Villanova",85,11
2022-02-12,"Seton Hall",67,"Villanova",73,6
2021-11-13,"North Alabama",99,"Virgin Islands",47,-52
2021-11-09,"Navy",66,"Virginia",58,-8
2021-11-12,"Radford",52,"Virginia",73,21
2021-11-19,"Coppin St.",52,"Virginia",68,16
2021-11-22,"Georgia",55,"Virginia",65,10
2021-11-26,"Lehigh",43,"Virginia",61,18
2021-11-29,"Iowa",75,"Virginia",74,-1
2021-12-03,"Pittsburgh",56,"Virginia",57,1
2021-12-18,"Fairleigh Dickinson",49,"Virginia",82,33
2021-12-22,"Clemson",67,"Virginia",50,-17
2022-01-12,"Virginia Tech",52,"Virginia",54,2
2022-01-15,"Wake Forest",63,"Virginia",55,-8
2022-01-24,"Louisville",52,"Virginia",64,12
2022-02-01,"Boston College",55,"Virginia",67,12
2022-02-05,"Miami FL",58,"Virginia",71,13
2022-02-12,"Georgia Tech",53,"Virginia",63,10
2021-11-09,"Maine",47,"Virginia Tech",82,35
2021-11-15,"Radford",39,"Virginia Tech",65,26
2021-11-18,"St. Francis PA",55,"Virginia Tech",85,30
2021-11-21,"Merrimack",43,"Virginia Tech",72,29
2021-11-24,"Memphis",69,"Virginia Tech",61,-8
2021-11-26,"Xavier",59,"Virginia Tech",58,-1
2021-12-04,"Wake Forest",80,"Virginia Tech",61,-19
2021-12-08,"Cornell",60,"Virginia Tech",93,33
2021-12-17,"St. Bonaventure",49,"Virginia Tech",86,37
2022-01-04,"N.C. State",68,"Virginia Tech",63,-5
2022-01-15,"Notre Dame",73,"Virginia Tech",79,6
2022-01-26,"Miami FL",78,"Virginia Tech",75,-3
2022-02-02,"Georgia Tech",66,"Virginia Tech",81,15
2022-02-07,"Pittsburgh",47,"Virginia Tech",74,27
2022-02-12,"Syracuse",59,"Virginia Tech",71,12
2021-11-09,"Carlow",55,"VMI",111,56
2021-11-16,"Keystone",35,"VMI",97,62
2021-11-24,"Presbyterian",59,"VMI",54,-5
2021-11-25,"Central Arkansas",67,"VMI",73,6
2021-11-30,"Clarks Summit",40,"VMI",88,48
2021-12-11,"Gardner Webb",61,"VMI",64,3
2022-01-01,"Furman",67,"VMI",76,9
2022-01-08,"UNC Greensboro",72,"VMI",56,-16
2022-01-20,"Samford",80,"VMI",99,19
2022-01-22,"Chattanooga",78,"VMI",74,-4
2022-01-29,"East Tennessee St.",79,"VMI",83,4
2022-02-04,"Western Carolina",69,"VMI",76,7
2022-02-10,"Mercer",79,"VMI",85,6
2022-02-12,"The Citadel",83,"VMI",79,-4
2021-11-09,"Hartford",59,"Wagner",77,18
2021-12-16,"Immaculata",46,"Wagner",104,58
2021-12-20,"Delaware St.",51,"Wagner",93,42
2022-01-06,"Bryant",81,"Wagner",84,3
2022-01-15,"St. Francis NY",76,"Wagner",81,5
2022-01-17,"Fairleigh Dickinson",64,"Wagner",95,31
2022-01-27,"St. Francis PA",54,"Wagner",69,15
2022-02-05,"LIU",64,"Wagner",79,15
2022-02-10,"Mount St. Mary's",57,"Wagner",69,12
2022-02-12,"Merrimack",80,"Wagner",65,-15
2021-11-10,"William & Mary",59,"Wake Forest",77,18
2021-11-12,"Western Carolina",75,"Wake Forest",87,12
2021-11-17,"Charleston Southern",59,"Wake Forest",95,36
2021-11-20,"North Carolina A&T",63,"Wake Forest",87,24
2021-11-23,"Kennesaw St.",61,"Wake Forest",92,31
2021-11-26,"Oregon St.",77,"Wake Forest",80,3
2021-11-27,"LSU",75,"Wake Forest",61,-14
2021-11-30,"Northwestern",73,"Wake Forest",77,4
2021-12-11,"USC Upstate",53,"Wake Forest",79,26
2021-12-14,"VMI",70,"Wake Forest",77,7
2021-12-17,"Charlotte",79,"Wake Forest",82,3
2022-01-04,"Florida St.",54,"Wake Forest",76,22
2022-01-08,"Syracuse",74,"Wake Forest",77,3
2022-01-12,"Duke",76,"Wake Forest",64,-12
2022-01-22,"North Carolina",76,"Wake Forest",98,22
2022-01-24,"Boston College",57,"Wake Forest",87,30
2022-02-02,"Pittsburgh",75,"Wake Forest",91,16
2022-02-12,"Miami FL",76,"Wake Forest",72,-4
2021-11-09,"Northern Illinois",71,"Washington",64,-7
2021-11-11,"Northern Arizona",62,"Washington",73,11
2021-11-15,"Texas Southern",65,"Washington",72,7
2021-11-18,"Wyoming",77,"Washington",72,-5
2021-11-22,"George Mason",74,"Washington",77,3
2021-11-27,"Winthrop",82,"Washington",74,-8
2021-12-18,"Seattle",56,"Washington",64,8
2021-12-21,"Utah Valley",68,"Washington",52,-16
2022-01-12,"California",55,"Washington",64,9
2022-01-15,"Stanford",64,"Washington",67,3
2022-01-27,"Colorado",58,"Washington",60,2
2022-01-29,"Utah",73,"Washington",77,4
2022-02-10,"Arizona St.",64,"Washington",87,23
2022-02-12,"Arizona",92,"Washington",68,-24
2021-11-09,"Alcorn St.",67,"Washington St.",85,18
2021-11-12,"Seattle",61,"Washington St.",79,18
2021-11-15,"UC Santa Barbara",65,"Washington St.",73,8
2021-11-22,"Winthrop",86,"Washington St.",92,6
2021-11-27,"Eastern Washington",76,"Washington St.",71,-5
2021-12-04,"USC",63,"Washington St.",61,-2
2021-12-08,"Weber St.",60,"Washington St.",94,34
2021-12-11,"South Dakota St.",77,"Washington St.",74,-3
2021-12-15,"New Mexico St.",64,"Washington St.",61,-3
2021-12-18,"Northern Colorado",56,"Washington St.",82,26
2021-12-22,"Boise St.",58,"Washington St.",52,-6
2022-01-13,"Stanford",62,"Washington St.",57,-5
2022-01-15,"California",57,"Washington St.",65,8
2022-01-26,"Utah",54,"Washington St.",71,17
2022-01-30,"Colorado",43,"Washington St.",70,27
2022-02-10,"Arizona",72,"Washington St.",60,-12
2022-02-12,"Arizona St.",58,"Washington St.",55,-3
2021-11-09,"Western Colorado",60,"Weber St.",100,40
2021-11-18,"Massachusetts",73,"Weber St.",88,15
2021-11-21,"Green Bay",58,"Weber St.",68,10
2021-12-02,"Northern Arizona",44,"Weber St.",67,23
2021-12-04,"Portland St.",69,"Weber St.",80,11
2021-12-11,"Maine Fort Kent",36,"Weber St.",82,46
2021-12-15,"Utah St.",95,"Weber St.",80,-15
2021-12-18,"BYU",89,"Weber St.",71,-18
2021-12-23,"Fresno St.",69,"Weber St.",43,-26
2022-01-13,"Idaho",74,"Weber St.",84,10
2022-01-20,"Idaho St.",63,"Weber St.",95,32
2022-01-31,"Eastern Washington",84,"Weber St.",90,6
2022-02-03,"Montana",75,"Weber St.",80,5
2022-02-05,"Montana St.",78,"Weber St.",57,-21
2021-11-09,"Oakland",53,"West Virginia",60,7
2021-11-12,"Pittsburgh",59,"West Virginia",74,15
2021-11-18,"Elon",68,"West Virginia",87,19
2021-11-19,"Marquette",82,"West Virginia",71,-11
2021-11-21,"Clemson",59,"West Virginia",66,7
2021-11-26,"Eastern Kentucky",77,"West Virginia",80,3
2021-11-30,"Bellarmine",55,"West Virginia",74,19
2021-12-04,"Radford",51,"West Virginia",67,16
2021-12-08,"Connecticut",53,"West Virginia",56,3
2021-12-12,"Kent St.",50,"West Virginia",63,13
2021-12-22,"Youngstown St.",52,"West Virginia",82,30
2022-01-08,"Kansas St.",68,"West Virginia",71,3
2022-01-11,"Oklahoma St.",60,"West Virginia",70,10
2022-01-18,"Baylor",77,"West Virginia",68,-9
2022-01-26,"Oklahoma",72,"West Virginia",62,-10
2022-02-05,"Texas Tech",60,"West Virginia",53,-7
2022-02-08,"Iowa St.",63,"West Virginia",79,16
2021-11-09,"Bowling Green",71,"Western Carolina",79,8
2021-11-19,"UMBC",91,"Western Carolina",75,-16
2021-12-01,"Warren Wilson",47,"Western Carolina",102,55
2021-12-08,"Tennessee Tech",69,"Western Carolina",74,5
2021-12-11,"UNC Asheville",73,"Western Carolina",72,-1
2022-01-05,"The Citadel",90,"Western Carolina",94,4
2022-01-12,"Chattanooga",59,"Western Carolina",70,11
2022-01-15,"Wofford",84,"Western Carolina",64,-20
2022-01-29,"Samford",74,"Western Carolina",64,-10
2022-02-02,"East Tennessee St.",84,"Western Carolina",87,3
2022-02-07,"UNC Greensboro",68,"Western Carolina",49,-19
2021-11-12,"Culver Stockton",69,"Western Illinois",91,22
2021-11-16,"Iowa Wesleyan",71,"Western Illinois",97,26
2021-11-27,"Miami OH",67,"Western Illinois",79,12
2021-12-01,"Ball St.",80,"Western Illinois",93,13
2021-12-04,"Tennessee Martin",64,"Western Illinois",81,17
2021-12-18,"Eastern Illinois",54,"Western Illinois",71,17
2022-01-08,"Oral Roberts",87,"Western Illinois",86,-1
2022-01-22,"South Dakota St.",93,"Western Illinois",75,-18
2022-01-24,"South Dakota",75,"Western Illinois",72,-3
2022-01-29,"St. Thomas",52,"Western Illinois",81,29
2022-01-31,"UMKC",83,"Western Illinois",75,-8
2022-02-10,"North Dakota St.",84,"Western Illinois",81,-3
2022-02-12,"North Dakota",68,"Western Illinois",70,2
2021-11-09,"Alabama St.",74,"Western Kentucky",79,5
2021-11-24,"Alabama A&M",62,"Western Kentucky",88,26
2021-11-27,"Tennessee Martin",66,"Western Kentucky",81,15
2021-11-30,"Rhodes",35,"Western Kentucky",105,70
2021-12-04,"Eastern Kentucky",80,"Western Kentucky",85,5
2021-12-08,"Buffalo",77,"Western Kentucky",67,-10
2021-12-14,"Centre",52,"Western Kentucky",90,38
2021-12-18,"Louisville",72,"Western Kentucky",82,10
2022-01-08,"FIU",71,"Western Kentucky",84,13
2022-01-13,"Rice",66,"Western Kentucky",80,14
2022-01-15,"North Texas",65,"Western Kentucky",60,-5
2022-01-27,"UAB",68,"Western Kentucky",65,-3
2022-01-29,"Middle Tennessee",93,"Western Kentucky",85,-8
2022-02-10,"Florida Atlantic",69,"Western Kentucky",76,7
2021-11-10,"Hope",58,"Western Michigan",76,18
2021-11-18,"Saginaw Valley St.",80,"Western Michigan",63,-17
2021-11-27,"Purdue Fort Wayne",85,"Western Michigan",93,8
2021-12-05,"Valparaiso",71,"Western Michigan",60,-11
2021-12-17,"Aquinas",56,"Western Michigan",67,11
2022-01-01,"Ohio",59,"Western Michigan",47,-12
2022-01-04,"Eastern Michigan",85,"Western Michigan",79,-6
2022-01-11,"Buffalo",78,"Western Michigan",64,-14
2022-01-15,"Miami OH",70,"Western Michigan",62,-8
2022-01-22,"Bowling Green",82,"Western Michigan",75,-7
2022-02-01,"Northern Illinois",75,"Western Michigan",56,-19
2022-02-12,"Central Michigan",63,"Western Michigan",77,14
2021-11-09,"Jacksonville St.",57,"Wichita St.",60,3
2021-11-13,"South Alabama",58,"Wichita St.",64,6
2021-11-16,"Tarleton St.",51,"Wichita St.",65,14
2021-11-19,"Arizona",82,"Wichita St.",78,-4
2021-12-05,"Kansas St.",65,"Wichita St.",59,-6
2021-12-11,"Norfolk St.",58,"Wichita St.",71,13
2021-12-14,"Alcorn St.",63,"Wichita St.",82,19
2021-12-18,"North Texas",62,"Wichita St.",52,-10
2021-12-22,"Prairie View A&M",66,"Wichita St.",102,36
2022-01-01,"Memphis",82,"Wichita St.",64,-18
2022-01-12,"Tulane",68,"Wichita St.",67,-1
2022-01-16,"Cincinnati",61,"Wichita St.",57,-4
2022-01-26,"UCF",79,"Wichita St.",84,5
2022-02-01,"Tulsa",48,"Wichita St.",58,10
2022-02-05,"SMU",57,"Wichita St.",72,15
2022-02-12,"South Florida",69,"Wichita St.",73,4
2021-11-12,"American",74,"William & Mary",62,-12
2021-11-20,"Georgia St.",77,"William & Mary",59,-18
2021-11-21,"Howard",82,"William & Mary",76,-6
2021-11-27,"Mary Baldwin",50,"William & Mary",87,37
2021-12-07,"Old Dominion",74,"William & Mary",59,-15
2021-12-09,"Hampton",54,"William & Mary",53,-1
2021-12-12,"Fairfield",70,"William & Mary",47,-23
2021-12-29,"Hofstra",62,"William & Mary",63,1
2021-12-31,"Northeastern",70,"William & Mary",71,1
2022-01-15,"James Madison",95,"William & Mary",91,-4
2022-01-17,"Towson",91,"William & Mary",69,-22
2022-01-29,"Elon",61,"William & Mary",65,4
2022-02-03,"Charleston",84,"William & Mary",61,-23
2022-02-05,"UNC Wilmington",92,"William & Mary",70,-22
2021-11-09,"Mary Baldwin",78,"Winthrop",110,32
2021-11-13,"Mercer",85,"Winthrop",88,3
2021-12-01,"Hartford",75,"Winthrop",82,7
2021-12-07,"Furman",80,"Winthrop",85,5
2021-12-11,"Carver",52,"Winthrop",83,31
2021-12-31,"Converse",40,"Winthrop",78,38
2022-01-10,"Campbell",72,"Winthrop",74,2
2022-01-13,"UNC Asheville",80,"Winthrop",86,6
2022-01-22,"Gardner Webb",62,"Winthrop",64,2
2022-02-03,"North Carolina A&T",54,"Winthrop",64,10
2022-02-09,"Radford",48,"Winthrop",58,10
2022-02-12,"Presbyterian",61,"Winthrop",65,4
2021-11-09,"St. Francis NY",58,"Wisconsin",81,23
2021-11-12,"Green Bay",34,"Wisconsin",72,38
2021-11-15,"Providence",63,"Wisconsin",58,-5
2021-11-22,"Texas A&M",58,"Wisconsin",69,11
2021-12-04,"Marquette",76,"Wisconsin",89,13
2021-12-08,"Indiana",59,"Wisconsin",64,5
2021-12-15,"Nicholls St.",68,"Wisconsin",71,3
2021-12-29,"Illinois St.",85,"Wisconsin",89,4
2022-01-06,"Iowa",78,"Wisconsin",87,9
2022-01-13,"Ohio St.",68,"Wisconsin",78,10
2022-01-21,"Michigan St.",86,"Wisconsin",74,-12
2022-01-30,"Minnesota",60,"Wisconsin",66,6
2022-02-05,"Penn St.",49,"Wisconsin",51,2
2022-02-12,"Rutgers",73,"Wisconsin",65,-8
2021-11-09,"Bob Jones",79,"Wofford",117,38
2021-11-15,"Erskine",41,"Wofford",98,57
2021-11-19,"Hampton",60,"Wofford",77,17
2021-11-21,"Georgia Southern",52,"Wofford",70,18
2021-12-01,"Richmond",73,"Wofford",64,-9
2021-12-05,"Kennesaw St.",62,"Wofford",88,26
2021-12-29,"VMI",80,"Wofford",73,-7
2022-01-05,"Chattanooga",75,"Wofford",67,-8
2022-01-12,"Samford",64,"Wofford",87,23
2022-01-19,"The Citadel",77,"Wofford",89,12
2022-01-22,"Furman",75,"Wofford",50,-25
2022-01-29,"UNC Greensboro",66,"Wofford",85,19
2022-02-05,"East Tennessee St.",60,"Wofford",62,2
2022-02-12,"Western Carolina",57,"Wofford",69,12
2021-11-09,"Lake Erie",53,"Wright St.",86,33
2021-11-23,"James Madison",78,"Wright St.",76,-2
2021-12-15,"Akron",66,"Wright St.",48,-18
2021-12-18,"Tennessee Tech",63,"Wright St.",72,9
2021-12-30,"Milwaukee",75,"Wright St.",80,5
2022-01-01,"Green Bay",69,"Wright St.",72,3
2022-01-06,"Illinois Chicago",72,"Wright St.",90,18
2022-01-08,"IUPUI",58,"Wright St.",72,14
2022-01-28,"Cleveland St.",71,"Wright St.",67,-4
2022-01-30,"Purdue Fort Wayne",63,"Wright St.",75,12
2022-02-04,"Detroit Mercy",59,"Wright St.",90,31
2022-02-05,"Oakland",64,"Wright St.",75,11
2021-11-10,"Detroit Mercy",47,"Wyoming",85,38
2021-11-14,"Arkansas Pine Bluff",45,"Wyoming",85,40
2021-11-26,"Hastings",59,"Wyoming",108,49
2021-12-02,"Denver",64,"Wyoming",77,13
2021-12-04,"McNeese St.",58,"Wyoming",79,21
2021-12-11,"Utah Valley",62,"Wyoming",74,12
2021-12-23,"Northern Iowa",69,"Wyoming",71,2
2022-01-19,"San Jose St.",69,"Wyoming",84,15
2022-01-22,"New Mexico",91,"Wyoming",93,2
2022-01-31,"Colorado St.",78,"Wyoming",84,6
2022-02-03,"Boise St.",65,"Wyoming",72,7
2022-02-08,"Utah St.",76,"Wyoming",78,2
2021-11-09,"Niagara",60,"Xavier",63,3
2021-11-12,"Kent St.",59,"Xavier",73,14
2021-11-18,"Ohio St.",65,"Xavier",71,6
2021-11-21,"Norfolk St.",48,"Xavier",88,40
2021-11-24,"Iowa St.",82,"Xavier",70,-12
2021-12-01,"Central Michigan",45,"Xavier",78,33
2021-12-08,"Ball St.",50,"Xavier",96,46
2021-12-11,"Cincinnati",63,"Xavier",83,20
2021-12-15,"Morehead St.",63,"Xavier",86,23
2021-12-18,"Marquette",71,"Xavier",80,9
2022-01-12,"Villanova",64,"Xavier",60,-4
2022-01-15,"Creighton",73,"Xavier",80,7
2022-01-26,"Providence",65,"Xavier",62,-3
2022-02-02,"Butler",66,"Xavier",68,2
2022-02-05,"DePaul",69,"Xavier",65,-4
2022-02-11,"Connecticut",68,"Xavier",74,6
2021-11-09,"Vassar",42,"Yale",88,46
2021-11-12,"Massachusetts",71,"Yale",91,20
2021-11-23,"Southern Utah",88,"Yale",85,-3
2021-11-28,"Stony Brook",85,"Yale",81,-4
2021-12-01,"Lehigh",72,"Yale",82,10
2021-12-07,"Albany",52,"Yale",71,19
2021-12-14,"Monmouth",69,"Yale",60,-9
2022-01-15,"Cornell",69,"Yale",96,27
2022-01-25,"Columbia",72,"Yale",83,11
2022-02-04,"Dartmouth",69,"Yale",72,3
2022-02-05,"Harvard",55,"Yale",58,3
2021-11-19,"St. Thomas",75,"Youngstown St.",79,4
2021-11-20,"SIU Edwardsville",69,"Youngstown St.",66,-3
2021-11-21,"Niagara",58,"Youngstown St.",53,-5
2021-12-08,"Central Michigan",77,"Youngstown St.",84,7
2021-12-11,"Canisius",43,"Youngstown St.",71,28
2021-12-18,"Westminster PA",54,"Youngstown St.",83,29
2021-12-29,"Defiance",56,"Youngstown St.",96,40
2022-01-07,"Purdue Fort Wayne",71,"Youngstown St.",61,-10
2022-01-09,"Cleveland St.",86,"Youngstown St.",80,-6
2022-01-13,"Northern Kentucky",68,"Youngstown St.",67,-1
2022-01-15,"Wright St.",87,"Youngstown St.",90,3
2022-01-27,"Green Bay",50,"Youngstown St.",63,13
2022-01-29,"Milwaukee",72,"Youngstown St.",86,14
2022-02-09,"Oakland",71,"Youngstown St.",78,7
2022-02-11,"Detroit Mercy",69,"Youngstown St.",82,13
